abolish=Bỏ
abortion=Sự phá thai
absence=Vắng mặt
absent=Vắng mặt
absurd=Ngớ ngẩn
abuse=Lạm dụng
academy=Học viện
accelerate=Thúc giục
acceptance=Chấp thuận
accessible=Có thể truy cập
accomplishment=Thành quả
accordingly=Theo đó
accountability=Trách nhiệm giải trình
accountable=Có trách nhiệm
accumulate=Tích trữ
accumulation=Sự tích trữ
accusation=Lời buộc tội
accused=Bị tố cáo
acid=Axit
acquisition=Sự thâu tóm
activation=Sự kích hoạt
activist=Nhà hoạt động
acute=Nhọn
adaptation=Sự thích nghi
adhere=Tuân thủ
adjacent=Liền kề
adjustment=Sự điều chỉnh
administer=Quản lý
administrative=Hành chính
administrator=Người quản lý
admission=Nhận vào
adolescent=Thanh niên
adoption=Nhận con nuôi
adverse=Bất lợi
advocate=Biện hộ
aesthetic=Thẩm mỹ
affection=Sự yêu mến
aftermath=Hậu quả
aggression=Sự hiếu chiến
agricultural=Nông nghiệp
aide=Phụ tá
alert=Báo động
alien=Người ngoài hành tinh
align=Căn chỉnh
alignment=Sự liên kết
alike=Như nhau
allegation=Sự cáo buộc
allege=Cáo buộc
allegedly=Bị cáo buộc
alliance=Liên minh
allocate=Chỉ định
allocation=Sự phân bổ
allowance=Trợ cấp
ally=Đồng minh
aluminum=Nhôm
amateur=Nghiệp dư
ambassador=Đại sứ
amend=Sửa đổi
amendment=Sự sửa đổi
amid=Ở giữa
analogy=Sự giống nhau
anchor=Mỏ neo
angel=Thiên thần
anonymous=Vô danh
apparatus=Bộ máy
apparel=May mặc
appealing=Hấp dẫn
appetite=Thèm ăn
applaud=Tán thưởng
applicable=Áp dụng
appoint=Bổ nhiệm
appreciation=Sự đánh giá
arbitrary=Bất kỳ
architectural=Kiến trúc
archive=Lưu trữ
arena=Đấu trường
arm=Cánh tay
array=Mảng
articulate=Nói rõ
ash=Tro
aspiration=Khát vọng
aspire=Khao khát
assassination=Sự am sát
assault=Hành hung
assemble=Tập hợp
assembly=Hội đồng, tổ hợp
assert=Khẳng định
assertion=Sự quả quyết
assurance=Đảm bảo
asylum=Tị nạn
atrocity=Sự tàn bạo
attain=Đạt được
attendance=Sự tham dự
attribute=Thuộc tính
auction=Bán đấu giá
audit=Kiểm toán
authentic=Thật
authorize=Ủy quyền
auto=Tự động
autonomy=Quyền tự trị
autumn=Mùa thu
availability=Khả dụng
await=Chờ đợi
backdrop=Phông nền
backing=Ủng hộ
backup=Sao lưu
bail=Tiền bảo lãnh
ballot=Phiếu
bankruptcy=Phá sản
banner=Ảnh bìa
bare=Để trần
barrel=Thùng
bass=Âm trầm                          
bat=Con dơi
battlefield=Chiến trường
bay=Vịnh
beam=Chùm tia
beast=Quái thú
behalf=Thay mặt
behavioral=Thuộc về hành vi
beloved=Yêu quý
bench=Băng ghế
benchmark=Điểm chuẩn
beneath=Ở bên dưới
beneficiary=Người thụ hưởng
betray=Phản bội
beverage=Đồ uống
bind=Trói buộc
biography=Tiểu sử
bishop=Giám mục
bizarre=Kỳ quái
blade=Lưỡi
blast=Vụ nổ
bleed=Chảy máu
blend=Trộn
bless=Ban phước
blessing=Phước lành
boast=Khoe khoang
bonus=Thưởng
booking=Đặt trước
boom=Bùng nổ
bounce=Nảy
boundary=Ranh giới
bow=Cây cung
breach=Vi phạm
breakdown=Phá vỡ
breakthrough=Đột phá
breed=Giống
broadband=Băng thông rộng
browser=Trình duyệt
brutal=Tàn bạo
buddy=Bạn bè
buffer=Đệm
bulk=Số lượng lớn
burden=Gánh nặng
bureaucracy=Quan liêu
burial=Mai táng
burst=Nổ
cabinet=Buồng
calculation=Phép tính
canvas=Tranh sơn dầu
capability=Khả năng
capitalism=Chủ nghĩa tư bản
capitalist=Nhà tư bản
cargo=Hàng hóa
carriage=Xe
carve=Khắc chạm
casino=Sòng bạc
casualty=Thương vong
catalog=Mục lục
cater=Phục vụ
cattle=Gia súc
caution=Thận trọng
cautious=Dè dặt
cease=Ngưng
cemetery=Nghĩa trang
chamber=Buồng
chaos=Sự hỗn loạn
characterize=Đặc điểm
charm=Quyến rũ
charter=Điều lệ
choir=Hợp xướng
chronic=Mãn tính
chunk=Khúc gỗ
circulate=Lưu hành
circulation=Vòng tuần hoàn
citizenship=Quyền công dân
civic=Dân sự
civilian=Dân thường
clarity=Trong trẻo
clash=Sự xung đột
classification=Sự phân loại
cling=Bám vào
clinical=Lâm sàng
closure=Khép kín
cluster=Cụm
coalition=Liên minh
coastal=Duyên hải
cocktail=Cốc tai
cognitive=Nhận thức
coincide=Trùng hợp
collaborate=Hợp tác
collaboration=Sự hợp tác
collective=Tập thể
collision=Va chạm
colonial=Thuộc địa
columnist=Chuyên mục
combat=Chiến đấu
commence=Bắt đầu
commentary=Bình luận
commentator=Bình luận viên
commerce=Thương mại
commissioner=Ủy viên
commodity=Hàng hóa
communist=Cộng sản
companion=Đồng hành
comparable=Có thể so sánh
compassion=Thương hại
compel=Ép buộc
compelling=Thuyết phục
compensate=Đền bù
compensation=Đền bù
competence=Năng lực
competent=Có thẩm quyền
compile=Biên dịch
complement=Bổ sung
complexity=Phức tạp
compliance=Sự tuân thủ
complication=Sự phức tạp
comply=Tuân theo
composition=Thành phần
compromise=Sự thỏa hiệp
compute=Tính toán
conceal=Che giấu
concede=Công nhận
conceive=Tưởng tượng
conception=Quan niệm
concession=Nhượng bộ
condemn=Lên án
confer=Trao
confession=Lời thú tội
configuration=Cấu hình
confine=Giam cầm
confirmation=Xác nhận
confront=Đối đầu
confrontation=Đối đầu
congratulate=Chúc mừng
congregation=Hội chúng
congressional=Quốc hội
conquer=Chinh phục
conscience=Lương tâm
consciousness=Ý thức
consecutive=Liên tiếp
consensus=Đoàn kết
consent=Bằng lòng
conserve=Bảo tồn
consistency=Tính nhất quán
consolidate=Củng cố
constitute=Cấu tạo
constitution=Tổ chức
constitutional=Hợp hiến
constraint=Hạn chế
consultation=Tham vấn
contemplate=Thưởng ngoạn
contempt=Khinh thường
contend=Tranh giành
contender=Đối thủ
content=Nội dung
contention=Sự tranh cãi
continually=Liên tục
contractor=Nhà thầu
contradiction=Mâu thuẫn
contrary=Trái ngược
contributor=Người đóng góp
conversion=Sự hoán cải
convict=Kết tội
conviction=Lòng tin chắc, sự kết án, phán quyết
cooperate=Hợp tác
cooperative=Hợp tác xã
coordinate=Điều phối
coordination=Sự phối hợp
coordinator=Người điều phối
copper=Đồng
copyright=Bản quyền
correction=Điều chỉnh
correlate=Tương quan
correlation=Tương quan
correspond=Trao đổi thư tín
correspondence=Thư tín
correspondent=Phóng viên
corresponding=Tương ứng
corrupt=Hư hỏng
corruption=Tham nhũng
costly=Tốn kém
councilor=Ủy viên hội đồng
counseling=Tư vấn
counselor=Cố vấn
counter =Phản đối 
counterpart=Đối tác
countless=Vô số
coup=Đảo chính
courtesy=Lịch sự
craft=Thủ công
crawl=Bò
creator=Người sáng tạo
credibility=Sự uy tín
credible=Đáng tin cậy
creep=Leo
critique=Phê bình
crown=Vương miện
crude=Thô thiển
crush=Người mình thích
crystal=Pha lê
cult=Sùng bái
cultivate=Cày cấy
curiosity=Sự tò mò
custody=Sự coi giư
cutting=Cắt
cynical=Hoài nghi
dam=Cái đập
damaging=Làm hư hại
dawn=Bình minh
debris=Mảnh vụn
debut=Ra mắt
decisive=Dứt khoát
declaration=Tờ khai
dedicated=Tận tụy
dedication=Cống hiến
deed=Chứng thư
deem=Cho là
default=Mặc định
defect=Khuyết điểm
defensive=Phòng ngự
deficiency=Sự thiếu hụt
deficit=Thiếu hụt, khuyết
defy=Thách thức
delegate=Ủy nhiệm
delegation=Phái đoàn
delicate=Thanh tú
demon=Con quỷ
denial=Từ chối
denounce=Tố cáo
dense=Ngu độn
density=Tỉ trọng
dependence=Sự phụ thuộc
depict=Miêu tả
deploy=Triển khai
deployment=Triển khai
deprive=Tước đoạt
deputy=Phó
descend=Hạ xuống
descent=Hạ xuống
designate=Chỉ định
desirable=Mong muốn
desktop=Máy tính để bàn
destructive=Phá hoại
detain=Giam
detection=Dò tìm
detention=Giam giữ
deteriorate=Xấu đi
devastate=Tàn phá
devil=Ác quỷ
devise=Nghĩ ra
diagnose=Chẩn đoán
diagnosis=Phép chẩn đoán
dictate=Ra lệnh
dictator=Nhà độc tài
differentiate=Phân biệt
dignity=Phẩm giá
dilemma=Tình trạng khó xử
dimension=Kích thước
diminish=Giảm bớt
dip=Nhúng, dìm
diplomat=Nhà ngoại giao
diplomatic=Thuộc về ngoại giao
directory=Danh mục
disastrous=Tai hại
discard=Bỏ đi
discharge=Phóng điện
disclose=Tiết lộ
disclosure=Tiết lộ
discourse=Đàm luận
discretion=Sự tùy ý
discrimination=Phân biệt
dismissal=Sa thải
displace=Dời chỗ
disposal=Thải bỏ
dispose=Vứt bỏ
dispute=Tranh chấp
disrupt=Làm gián đoạn
disruption=Gián đoạn
dissolve=Tan biến
distinction=Sự phân biệt
distinctive=Đặc biệt
distort=Xuyên tạc
distress=Phiền muộn
disturbing=Phiền
divert=Chuyển hướng
divine=Thần thánh
doctrine=Học thuyết
documentation=Tài liệu
domain=Miền
dominance=Sự thống trị
donor=Nhà tài trợ
dose=Liều lượng
drain=Làm khô hạn
drift=Trôi dạt
driving=Điều khiển
drown=Chết chìm
dual=Hai
dub=Lồng tiếng
dumb=Câm
duo=Cặp đôi
dynamic=Năng động
earnings=Thu nhập
ease=Xoa dịu
echo=Tiếng vang
ecological=Sinh thái
educator=Nhà giáo dục
effectiveness=Tính hiệu quả
efficiency=Hiệu quả
ego=Cái tôi
elaborate=Phức tạp
electoral=Bầu cử
elevate=Nâng
eligible=Đạt chuẩn
elite=Thượng lưu
embark=Tham gia
embarrassment=Sự lúng túng
embassy=Đại sứ quán
embed=Nhúng
embody=Hiện thân
emergence=Sự xuất hiện
empirical=Theo kinh nghiệm
empower=Trao quyền
enact=Ban hành
encompass=Bao trùm
encouragement=Sự khích lệ
encouraging=Khích lệ
endeavor=Nỗ lực
endless=Bất tận
endorse=Chứng thực
endorsement=Sự chứng thực
endure=Chịu đựng
enforce=Thi hành
enforcement=Hành động thực thi
engagement=Hôn ước
engaging=Hấp dẫn
enrich=Làm giàu
enroll=Ghi danh
ensue=Tiếp theo
enterprise=Xí nghiệp
enthusiast=Người say mê
entitle=Cho phép
entity=Thực thể
epidemic=Bệnh dịch
equality=Bình đẳng
equation=Phương trình
erect=Dựng lên
escalate=Leo thang
essence=Bản chất
establishment=Thành lập
eternal=Vĩnh hằng
evacuate=Sơ tán
evoke=Gợi lên
evolutionary=Tiến hóa
exaggerate=Nói quá
excellence=Xuất sắc
exceptional=Đặc biệt
excess=Thặng dư 
exclusion=Sự loại trừ
exclusive=Loại trừ
exclusively=Duy nhất
execute=Hành hình
execution=Chấp hành
exert=Gắng sức
exile=Đày ải
expenditure=Chi phí
experimental=Thực nghiệm
expire=Hết hạn
explicit=Rõ ràng
explicitly=Một cách rõ ràng
exploitation=Khai thác
explosive=Nổ
extract=Trích xuất
extremist=Cực đoan
facilitate=Tạo điều kiện
faction=Phe phái
fade=Phai màu
fairness=Công bằng
fatal=Gây tử vong
fate=Định mệnh
favorable=Thuận lợi
feat=Kỳ công
felony=Trọng tội
feminist=Nữ quyền
fiber=Chất xơ
fierce=Hung dữ
filmmaker=Nhà làm phim
filter=Lọc
fine=Khỏe
firearm=Súng cầm tay
fiscal=Ngân sách
fit=Phù hợp
flaw=Khuyết điểm
flawed=Thiếu sót
flee=Chạy trốn
fleet=Hạm đội
flesh=Thịt
flexibility=Uyển chuyển
flourish=Hưng thịnh
fluid=Dịch
footage=Cảnh quay
foreigner=Người nước ngoài
forge=Làm giả
formula=Công thức
formulate=Xây dựng
forth=Ra ngoài
forthcoming=Sắp tới
foster=Nuôi dưỡng
fragile=Dễ vỡ
franchise=Nhượng quyền thương mại
frankly=Thẳng thắn
freshman=Sinh viên năm nhất
frustrated=Bực bội
frustrating=Làm nản lòng
frustration=Thất vọng
functional=Chức năng
fundraising=Gây quỹ
funeral=Tang lễ
gambling=Bài bạc
gathering=Thu thập
gaze=Nhìn
gear=Hộp số
generic=Chung
genocide=Sự diệt chủng
gig=Hợp đồng biểu diễn
glance=Nhìn lướt qua
glimpse=Nhìn thoáng qua
glorious=Vinh quang
glory=Vinh quang
governance=Quản trị
grace=Duyên dáng
grasp=Sự hiểu biết
grave=Mồ mả/Nghiêm trang
gravity=Trọng lực
grid=Lưới
grief=Nỗi buồn
grin=Cười toe toét
grind=Mài
grip=Nắm chặt
gross=Tổng
guerrilla=Du kích
guidance=Sự hướng dẫn
guilt=Tội lỗi
gut=Ruột
hail=Kêu
halfway=Nửa chừng
halt=Tạm dừng lại
handful=Một nắm đầy tay
handling=Sự điều khiển
handy=Tiện dụng
harassment=Quấy rối
hardware=Phần cứng
harmony=Hòa hợp
harsh=Thô ráp
harvest=Mùa gặt
hatred=Sự thù ghét
haunt=Ám ảnh
hazard=Hiểm nguy
heighten=Nâng cao
heritage=Gia tài
hierarchy=Hệ thống cấp bậc
hint=Dấu
homeland=Quê hương
hook=Cái móc
hopeful=Hy vọng
horizon=Chân trời
horn=Sừng
hostage=Con tin
hostile=Thù địch
hostility=Sự thù địch
humanitarian=Nhân đạo
humanity=Nhân loại
humble=Khiêm tốn
hydrogen=Hydro
identification=Nhận biết
ideological=Ý thức hệ
ideology=Hệ tư tưởng
idiot=Thằng ngốc
ignorance=Ngu dốt
imagery=Hình ảnh
immense=Bao la
imminent=Sắp xảy ra
implementation=Thực hiện
imprison=Bỏ tù
inability=Không có khả năng
inadequate=Không thỏa đáng
inappropriate=Không thích hợp
incarcerate=Giam giữ
incarceration=Sự giam giữ
incidence=Tỷ lệ mắc bệnh
inclined=Nghiêng
inclusion=Bao gồm
incur=Gánh chịu
indicator=Chỉ báo
indictment=Cáo trạng
indigenous=Bản địa
induce=Gây ra
indulge=Thưởng thức
inequality=Bất bình đẳng
infamous=Khét tiếng
infant=Trẻ sơ sinh
infect=Lây nhiễm
inflict=Gây thiệt
influential=Có ảnh hưởng
inherent=Vốn có
inhibit=Ức chế
initiate=Khởi xướng
inject=Tiêm thuốc
injection=Mũi tiêm
injustice=Sự bất công
inmate=Tù nhân
inquire=Hỏi thăm
insertion=Sự chèn
insider=Người trong cuộc
inspect=Quan sát
inspection=Điều tra
inspiration=Nguồn cảm hứng
instinct=Bản năng
institutional=Thể chế
instruct=Dạy
instrumental=Nhạc cụ
insufficient=Không đủ
insult=Sự sỉ nhục
intact=Nguyên vẹn
intake=Đầu vào
integral=Tích phân
integrated=Tích hợp
integration=Hội nhập
integrity=Sự toàn vẹn
intellectual=Trí thức
intensify=Tăng cường
intensity=Cường độ
intensive=Căng
intent=Ý định
interactive=Tương tác
interface=Giao diện
interfere=Can thiệp
interference=Sự can thiệp
interim=Tạm thời
interior=Nội địa
intermediate=Trung gian
intersection=Ngã tư
intervene=Can thiệp
intervention=Sự can thiệp
intimate=Thân mật
intriguing=Hấp dẫn
inventory=Hàng tồn kho
investigator=Người điều tra
invisible=Vô hình
invoke=Cầu khẩn
involvement=Sự tham gia
ironic=Mỉa mai
ironically=Trớ trêu thay
irony=Trớ trêu
irrelevant=Không liên quan
isolation=Sự cách ly
judicial=Tư pháp
jurisdiction=Quyền hạn
just=Chỉ
justification=Sự biện minh
keen=Sắc sảo
kidnap=Bắt cóc
kidney=Quả thận
kingdom=Vương quốc
landlord=Chủ nhà
landmark=Phong cảnh
lap=Lòng
laser=Tia laze
latter=Sau này
lawmaker=Người ban hành luật
lawn=Bãi cỏ
lawsuit=Kiện cáo
layout=Cách trình bày
leak=Hở
leap=Nhảy vọt
legacy=Di sản
legendary=Huyền thoại
legislation=Pháp luật
legislative=Lập pháp
legislature=Cơ quan lập pháp
legitimate=Hợp pháp
lengthy=Dài dòng
lesbian=Đồng tính nữ
lesser=Ít hơn
lethal=Gây chết người
liable=Chịu trách nhiệm
liberal=Phóng khoáng
liberation=Giải phóng
liberty=Sự tự do
lifelong=Suốt đời
likelihood=Khả năng xảy ra
limb=Chân tay
linear=Tuyến tính
lineup=Xếp hàng
linger=Nán lại
listing=Danh sách
liter=Lít
literacy=Trình độ học vấn
liver=Gan
lobby=Sảnh đợi
log=Khúc gỗ
logic=Hợp lý
longtime=Thời gian dài
loom=Khung cửi
loop=Vòng
loyalty=Lòng trung thành
machinery=Máy móc
magical=Huyền diệu
magnetic=Từ tính
magnificent=Tráng lệ
magnitude=Kích cỡ
mainland=Đất liền
mainstream=Xu hướng
maintenance=Sự bảo trì
mandate=Thi hành
mandatory=Bắt buộc
manifest=Rõ ràng
manipulate=Vận dụng
manipulation=Thao tác
manuscript=Bản thảo
march=Tháng Ba
marginal=Ngoài lề
marine=Hàng hải
marketplace=Thương trường
mask=Mặt nạ
massacre=Tàn sát
mathematical=Toán học
mature=Trưởng thành
maximize=Tối đa hóa
meaningful=Có ý nghĩa
meantime=Chờ đợi
medieval=Thời trung cổ
meditation=Thiền
melody=Làn điệu
memo=Bản ghi nhớ
memoir=Hồi ký
memorial=Đài kỷ niệm
mentor=Người hướng dẫn
merchant=Người buôn bán
mercy=Nhân từ
mere=Chỉ là
merely=Đơn thuần
merge=Hợp nhất
merger=Sự hợp nhất
merit=Công lao
methodology=Phương pháp luận
midst=Ở giữa
migration=Sự di cư
militant=Dân quân
militia=Dân quân
mill=Cối xay
minimal=Tối thiểu
minimize=Giảm thiểu
mining=Khai thác mỏ
ministry=Bộ
minute=Phút
miracle=Phép màu
misery=Khốn khổ
misleading=Gây hiểu lầm
missile=Hỏa tiễn
mob=Đám đông
mobile=Di động
mobility=Tính di động
mobilize=Huy động
moderate=Vừa phải
modification=Sự sửa đổi
momentum=Quán tính
monk=Tu sĩ
monopoly=Sự độc quyền
morality=Đạo đức
motive=Động cơ
municipal=Thành phố trực thuộc trung ương
mutual=Qua lại
namely =Cụ thể là
nationwide=Trên toàn quốc
naval=Hải quân
neglect=Sao nhãng
neighboring=Láng giềng
nest=Tổ
net=Mạng lưới
newsletter=Bản tin
niche=Thích hợp
noble=Cao quý
nod=Gật đầu
nominate=Đề cử
nomination=Sự đề cử
nominee=Người được đề cử
nonetheless=Dù sao thì
nonprofit=Phi lợi nhuận
nonsense=Vô lý
noon=Không bật
notable=Đáng chú ý
notably=Một cách đáng chú ý
notify=Thông báo
notorious=Khét tiếng
novel=Cuốn tiểu thuyết
nursery=Nhà trẻ
objection=Sự phản đối
oblige=Bắt buộc
obsess=Ám ảnh
obsession=Nỗi ám ảnh
occasional=Thỉnh thoảng
occurrence=Tần suất xảy ra
odds=Tỷ lệ cược
offering=Chào bán
offspring=Con đẻ
operational=Hoạt động
opt=Quyết định sáng suốt
optical=Quang học
optimism=Lạc quan
oral=Miệng
organizational=Tổ chức
orientation=Định hướng
originate=Bắt nguồn
outbreak=Sự bùng phát
outing=Đi chơi xa
outlet=Chỗ thoát
outlook=Quan điểm
outrage=Sự phẫn nộ
outsider=Người ngoài cuộc
overlook=Bỏ qua
overly=Quá mức
oversee=Giám sát
overturn=Lật ngửa
overwhelm=Lấn át
overwhelming=Choáng ngợp
pad=Tập giấy
parameter=Tham số
parental=Thuộc về cha mẹ
parliament=Nghị viện
partial=Thuộc về phần tử
partially=Một phần
passing=Đi qua
passive=Thụ động
pastor=Mục sư
patent=Bằng sáng chế
pathway=Con đường
patrol=Tuần tra
patron=Người bảo trợ
peak=Đỉnh cao
peasant=Tá điền
peculiar=Kỳ lạ
pension=Lương hưu
persist=Kiên trì
persistent=Kiên trì
personnel=Nhân viên
petition=Đơn kiến nghị
philosopher=Triết gia
philosophical=Triết học
pioneer=Người đi tiên phong
pipeline=Đường ống
pirate=Cướp biển
pit=Hố
plea=Lời thú tội
plead=Biện hộ
pledge=Lời hứa
plug=Phích cắm
plunge=Lao xuống
pole=Cây sào
poll=Cuộc thăm dò ý kiến
pond=Ao
pop=Nhạc pop
portfolio=Danh mục đầu tư
portray=Vẽ chân dung
postpone=Hoãn
postwar=Sau chiến tranh
practitioner=Người hành nghề
preach=Thuyết giáo
precedent=Tiền lệ
precision=Độ chính xác
predator=Động vật ăn thịt
predecessor=Người tiền nhiệm
predominantly=Chủ yếu
pregnancy=Thai kỳ
prejudice=Định kiến
preliminary=Sơ bộ
premier=Đứng đầu
premise=Tiền đề
premium=Phần thưởng
prescribe=Kê đơn
prescription=Đơn thuốc
presently=Hiện tại
preservation=Sự bảo tồn
preside=Chủ tọa
presidency=Nhiệm kỳ tổng thống
prestigious=Uy tín
presumably=Có lẽ
presume=Phỏng đoán
prevail=Chiếm ưu thế
prevalence=Sự phổ biến
prevention=Phòng ngừa
prey=Con mồi
privatization=Tư nhân hóa
privilege=Đặc ân
probe=Thăm dò
problematic=Có vấn đề
proceeding=Tiến hành
proceeds=Tiền thu được
processing=Chế biến
processor=Bộ xử lý
proclaim=Tuyên bố
productive=Hiệu quả
productivity=Năng suất
profitable=Có lãi
profound=Thâm thúy
projection=Hình chiếu
prominent=Nổi bật
pronounced=Phát âm
propaganda=Tuyên truyền
proposition=Dự luật
prosecute=Truy tố
prosecution=Sự truy tố
prosecutor=Công tố viên
prospective=Có triển vọng
prosperity=Sự phồn vinh
protective=Bảo vệ
protocol=Giao thức
province=Địa bàn tỉnh
provincial=Tỉnh lẻ
provision=Điều khoản
provoke=Khiêu khích
psychiatric=Tâm thần học
pulse=Xung
pump=Bơm
punch=Cú đấm
query=Truy vấn
quest=Nhiệm vụ
quota=Hạn ngạch
radar=Ra đa
radical=Căn bản
rage=Cơn thịnh nộ
raid=Đột kích
rally=Tập hợp
ranking=Xếp hạng
rape=Hiếp dâm
ratio=Tỉ lệ
rational=Hợp lý
ray=Cá đuối
readily=Sẵn sàng
realization=Hiện thực hóa
realm=Cảnh giới
rear=Ở phía sau
reasoning=Lý luận
reassure=Trấn an
rebel=Nổi loạn
rebellion=Sự nổi loạn
recipient=Người nhận
reconstruction=Sự tái thiết
recount=Kể lại
recruitment=Tuyển dụng
referendum=Trưng cầu dân ý
reflection=Sự phản xạ
reform=Cải cách
refuge=Nơi ẩn náu
refusal=Từ chối
regain=Lấy lại
regardless=Bất kể
regime=Chế độ
regulator=Người quản lý
regulatory=Quy định
rehabilitation=Sự phục hồi
reign=Trị vì
rejection=Sự từ chối
relevance=Sự liên quan
reliability=Độ tin cậy
reluctant=Lưỡng lự
remainder=Phần còn lại
remains=Còn lại
remedy=Phương thuốc
reminder=Lời nhắc nhở
removal=Loại bỏ
render=Kết xuất
renew=Thay mới
renowned=Nổi tiếng
replacement=Sự thay thế
reportedly=Được báo cáo
representation=Đại diện
reproduce=Tái sản xuất
reproduction=Sinh sản
republic=Cộng hòa
resemble=Giống
reside=Cư trú tại
residence=Nơi cư trú
residential=Khu dân cư
residue=Phần còn lại
resignation=Sự từ chức
resistance=Sức cản
respective=Tương ứng
respectively=Tương ứng
restoration=Sự phục hồi
restraint=Kiềm chế
resume=Sơ yếu lý lịch
retreat=Rút lui
retrieve=Lấy lại
revelation=Sự tiết lộ
revenge=Sự trả thù
reverse=Đảo ngược
revival=Sự hồi sinh
revive=Hồi sinh
revolutionary=Cách mạng
rhetoric=Hùng biện
rifle=Súng trường
riot=Bạo loạn
rip=Xé toạc
ritual=Nghi thức
robust=Cường tráng
rock=Đá
rod=Gậy
rookie=Tân binh
roster=Bảng phân công
rotate=Quay
rotation=Vòng xoay
ruling=Cai trị
rumor=Tin đồn
sacred=Linh thiêng
sacrifice=Hy sinh
saint=Thánh
sake=Lợi ích
sanction=Phê chuẩn
say=Nói
scattered=Rải rác
scope=Phạm vi
screw=Đinh ốc
scrutiny=Xem xét kỹ lưỡng
seal=Niêm phong
secondly=Thứ hai
secular=Thế tục
seemingly=Có vẻ
segment=Bộ phận
seize=Nắm bắt
seldom=Hiếm khi
selective=Chọn lọc
sensation=Cảm giác
sensitivity=Nhạy cảm
sentiment=Tình cảm
separation=Tách biệt
serial=Nối tiếp
settlement=Định cư
setup=Thành lập
sexuality=Tính tình dục
shareholder=Cổ đông
shatter=Làm vỡ
shed=Túp lều
sheer=Tuyệt đối
shipping=Đang chuyển hàng
shoot=Bắn
shrink=Co lại
shrug=Nhún vai
sigh=Thở dài
simulate=Mô phỏng
simulation=Sự mô phỏng
simultaneously=Đồng thời
sin=Tội lỗi
situated=Nằm
skeptical=Hoài nghi
sketch=Bản phác thảo
skip=Nhảy
slam=Sập
slap=Cái tát
slash=Gạch chéo
slavery=Chế độ nô lệ
slot=Chỗ
smash=Đập vỡ
snap=Búng tay
soak=Ngâm
soar=Bay lên
socialist=Nhà xã hội học
sole=Duy Nhất
solely=Cô độc
solidarity=Tinh thần đoàn kết
solo=Đấu
sophomore=Sinh viên năm hai
sound=Âm thanh
sovereignty=Chủ quyền
spam=Thư rác
span=Nhịp
spare=Bổ sung
spark=Tia lửa
specialized=Chuyên
specification=Sự chỉ rõ
specimen=Mẫu vật
spectacle=Cảnh tượng
spectrum=Quang phổ
spell=Đánh vần
sphere=Quả cầu
spin=Quay
spine=Xương sống
spotlight=Đốm sáng
spouse=Vợ chồng
spy=Gián điệp
squad=Đội hình
squeeze=Vắt kiệt
stab=Cú đâm
stability=Sự ổn định
stabilize=Ổn định
stake=Cổ phần
standing=Đứng
stark=Ngay đơ
statistical=Thống kê
steer=Chỉ đạo
stem=Thân cây
stereotype=Khuôn mẫu
stimulus=Kích thích
stir=Khuấy động
storage=Kho
straightforward=Thẳng thắn
strain=Sự căng thẳng
strand=Sợi dây
strategic=Chiến lược
striking=Nổi bật
strip=Dải/Cởi bỏ 
strive=Phấn đấu
structural=Cấu trúc
stumble=Tình cờ gặp
stun=Choáng váng
submission=Nộp hồ sơ
subscriber=Người đăng kí
subscription=Đăng ký
subsidy=Trợ cấp
substantial=Đáng kể
substantially=Đáng kể
substitute=Thay thế
substitution=Sự thay thế
subtle=Tế nhị
suburban=Ngoại ô
succession=Sự kế vị
successive=Tính nối tiếp nhau
successor=Người kế vị
suck=Hút
sue=Kiện
suicide=Tự sát
suite=Thượng hạng
summit=Hội nghị thượng đỉnh
superb=Tuyệt vời
superintendent=Giám thị
superior=Cấp trên
supervise=Giám sát
supervision=Giám sát viên
supervisor=Người giám sát
supplement=Phần bổ sung
supportive=Ủng hộ
supposedly=Được cho là
suppress=Kìm nén
supreme=Tối cao
surge=Dâng trào
surgical=Phẫu thuật
surplus=Số dư
surrender=Đầu hàng
surveillance=Giám sát
suspension=Đình chỉ
suspicion=Sự nghi ngờ
suspicious=Khả nghi
sustain=Duy trì
swing=Lung lay
sword=Thanh kiếm
symbolic=Tượng trưng
syndrome=Hội chứng
synthesis=Sự tổng hợp
systematic=Có hệ thống
tackle=Giải quyết
tactic=Chiến thuật
tactical=Chiến thuật
taxpayer=Người đóng thuế
tempt=Cám dỗ
tenant=Người thuê nhà
tender=Mềm
tenure=Nhiệm kỳ
terminal=Phần cuối
terminate=Chấm dứt
terrain=Địa hình
terrific=Khủng khiếp
testify=Làm chứng
testimony=Lời khai
texture=Kết cấu
thankfully=Thật may mắn
theatrical=Thuộc sân khấu
theology=Thần học
theoretical=Lý thuyết
thereafter=Sau đó
thereby=Bằng cách ấy
thoughtful=Chu đáo
thread=Chủ đề
threshold=Ngưỡng cửa
thrilled=Hồi hộp
thrive=Phát triển
tide=Thủy triều
tighten=Thắt chặt
timber=Gỗ
timely=Hợp thời
tobacco=Thuốc lá
tolerance=Sức chịu đựng
tolerate=Tha thứ
toll=Thu phí
top=Đứng đầu
torture=Tra tấn
toss=Quăng
total=Toàn bộ
toxic=Chất độc hại
trace=Dấu vết
trademark=Nhãn hiệu
trail=Đường mòn
trailer=Giới thiệu tóm tắt
transaction=Giao dịch
transcript=Bảng điểm
transformation=Sự biến đổi
transit=Quá cảnh
transmission=Truyền tải
transparency=Minh bạch
transparent=Trong suốt
trauma=Tổn thương
treaty=Hiệp ước
tremendous=To lớn
tribal=Bộ lạc
tribute=Cống vật
trigger=Kích hoạt
trio=Bộ ba
triumph=Chiến thắng
trophy=Chiếc cúp
troubled=Rắc rối
trustee=Người được ủy thác
tuition=Học phí
tumor=Khối u
turnout=Tắt
turnover=Doanh số
twist=Xoắn
unconstitutional=Vi hiến
undergraduate=Đại học
underlying=Cơ bản
undermine=Hủy hoại
undoubtedly=Không nghi ngờ
unify=Thống nhất
unprecedented=Chưa từng có
unveil=Tiết lộ
upcoming=Sắp tới
upgrade=Nâng cấp
uphold=Đề cao
utility=Tính thiết thực
utilize=Tận dụng
utterly=Hoàn toàn
vacuum=Máy hút bụi
vague=Mơ hồ
validity=Hợp lệ
vanish=Tan biến
variable=Biến đổi
varied=Đa dạng
vein=Tĩnh mạch
venture=Liên doanh
verbal=Bằng lời nói
verdict=Bản án
verify=Kiểm chứng
verse=Thơ
versus=Đấu với
vessel=Tàu
veteran=Cựu chiến binh
viable=Khả thi
vibrant=Sôi động
vice=Hành vi xấu xa
vicious=Luẩn quẩn
violate=Xâm phạm
violation=Sự vi phạm
virtue=Đức hạnh
vocal=Giọng hát
vow=Lời thề
vulnerability=Sự dễ bị tổn thương
vulnerable=Dễ bị tổn thương
ward=Khu vực
warehouse=Kho
warfare=Chiến tranh
warrant=Bảo đảm
warrior=Chiến binh
weaken=Làm suy yếu
weave=Dệt
weed=Cần sa
well=Tốt
whatsoever=Bất cứ điều gì
whereby=Nhờ đó
whip=Roi da
wholly=Hoàn toàn
widen=Mở rộng
widow=Góa phụ
width=Bề rộng
willingness=Sự tự nguyện
wipe=Lau đi
wit=Mưu mẹo
withdrawal=Rút tiền
workout=Tập thể dục
worship=Thờ cúng
worthwhile=Đáng giá
worthy=Xứng đáng
yell=La lên
yield=Sản sinh
