apartment=Căn hộ
ago=Trước kia
agree=Đồng ý
above=Bên trên
august=Tháng tám
aunt=Dì,cô,thím
apple=Quả táo
air=Không khí
across=Băng qua
action=Hành động
activity=Hoạt động
actor=Diễn viên nam
actress=Diễn viên nữ
add=Cộng,thêm vào
address=Địa chỉ,đính kèm
adult=Người lớn
advice=Lời khuyên
afraid=Sợ hãi
after=Sau khi
afternoon=Buổi chiều
again=Lại lần nữa
age=Tuổi
airport=Sân bay
all=Tất cả
also=Cũng
always=Luôn luôn
amazing=Thú vị,tuyệt vời
and=Và
angry=Tức giận
animal=Động vật
answer=Câu trả lời,trả lời
anyone=Bất cứ ai,ai đó
anything=Thứ gì đó
april=Tháng 4
area=Diện tích,khu vực
arm=Cánh tay
around=Xung quanh
arrive=Đến(xa đến gần)
art=Nghệ thuật,mỹ thuật
article=Bài báo
artist=Nghệ sĩ
ask=Hỏi
autumn=Mùa thu
baby=Em bé
back=Trở lại
bad=Tồi tệ
bag=Cặp,túi
ball=Quả bóng
banana=Qủa chuối
band=Ban nhạc
bank=Ngân hàng
bath=Bồn tắm
bathroom=Phòng tắm
beach=Bãi biển
beautiful=Xinh đẹp
because=Bời vì
become=Trở thành
bed=Giường ngủ
bedroom=Phòng ngủ
beer=Bia
before=Trước đây
begin=Bắt đầu
behind=Đằng sau
believe=Tin tưởng
below=Bên dưới
best=Tốt nhất
better=Tốt hơn
between=Ỏ giữa
bicycle=Xe dạp
big=To lớn
bike=Xe đạp
bill=Hoá đơn
bird=Con chim
birthday=Sinh nhất
black=Màu đen
blog=Blog
blonde=Vàng hoe
blue=Xanh nước biển
boat=Thuyền
body=Cơ thể
book=Quyển sách
boot=Đôi ủng
bored=Buồn chán
boring=Buồn chán
born=Sinh ra
both=Cả 2
bottle=Chai,bình
box=Hộp
boy=Con trai
boyfriend=Bạn trai
bread=Bánh mì
break=Vỡ,phá
breakfast=Bữa sáng
bring=Cầm
brother=Anh/em trai
brown=Màu nâu
build=Xây dựng
building=Toà nhà
bus=Xe buýt
business=Việc kinh doanh
busy=Bận rộn
butter=Bơ
buy=Mua
bye=Tạm biệt
cafe=Cửa hàng cafe
cake=Bánh
call=Gọi
camera=Camera
can=Có thể
capital=Thủ đô
car=Xe hơi
card=Thẻ
career=Sự nghiệp
carrot=Cả rốt
carry=Gánh
cat=Mèo
centre=Trung tâm
century=Thế kỷ
chair=Ghế
change=Thay đổi
chart=Đồ thị
cheap=Rẻ
check=Kiểm tra
cheese=Phô mai
chicken=Ga
child=Đứa trẻ
chocolate=Sô cô la
choose=Chọn lựa
cinema=Rạp chiếu phim
city=Thành phố
class=Lớp học
classroom=Phòng học 
clean=Sạch sẽ
climb=Leo trèo
clock=Đồng hồ
close=Đóng
clothes=Quần áo
club=Câu lạc bộ
coat=Áo choàng
coffee=Cà phê
cold=Lạnh
college=Đại học,cao đẳng
colour=Màu sắc
come=Đến(Gần đến xa)
common=Điểm chung,phổ biến
company=Công ty
compare=So sánh
complete=Hoàn thành
concert=Buổi hoà nhạc
conversation=Cuộc hội thoại
cook=Nấu ăn
cool=Mát mẻ
correct=Chính xác
cost=Giá cả
could=Cần
country=Quê hương
course=Khoá học
cousin=Anh chị em họ
cow=Con bò
cream=Kem
create=Tạo ra
culture=Nền văn hoá
cup=Cốc,cúp
customer=Khách hàng
cut=Cắt
dad=Bố
dance=Khiêu vũ
dancer=Vũ công
dangerous=Nguy hiểm
dark=Bóng tối
date=Ngày,hẹn hò
daughter=Con gái
day=ngày
dear=Thân gửi
december=Tháng 12
decide=Quyết định
delicious=Ngon miệng
describe=Mô tả
description=Chú thích
design=Thiết kế
desk=Bàn
detail=Chi tiết
dialogue=Hội thoại
dictionary=Từ điển
die=Chết
diet=Chế độ ăn
difference=Sự khác nhau
difficult=Khó
dinner=Bữa tối
dirty=Bẩn thỉu
discuss=Thảo luận
dish=Bát đĩa
doctor=Bác sĩ
dog=Chó
door=Cửa
down=Xuống
downstair=Dưới nhà
draw=Vẽ
dress=Váy
drink=Uống
driver=Tài xế
during=Trong suốt
each=Mỗi
ear=Tai
early=Sớm
east=Hướng đông
easy=Dễ dàng
eat=Ăn
egg=Trứng
eight=Tám
eighteen=Mười tám
eighty=Tám mươi
elephant=Voi
eleven=Mười một
email=Thư điện tử
end=Kết thúc
enjoy=Tận hưởng
enough=Đầy đủ
even=Thậm chí
evening=Tối
event=Sự kiện
ever=Bao giờ
every=Mọi
everybody=Mọi người
everyone=Tất cả mọi người
everything=Mọi điều
exam=Bài thi,kỳ thi
example=Thí dụ
excited=Háo hức
exciting=Thú vị
exercise=Tập thể dục
expensive=Đắt
explain=Giải thích
extra=Thêm
eye=Con mắt
face=Mặt
fact=Thực tế
fall=Rơi
false=Sai
family=Gia đình
famous=Nổi tiếng
fantastic=Tuyệt vời
far=Xa
farm=Nông trại
farmer=Nông dân
fast=Nhanh
fat=Mập mạp
father=Cha
favourite=Yêu thích
february=Tháng hai
feeling=Cảm giác
festival=Ngày hội
few=Vài
fifteen=Mười lăm
fifth=Thứ năm
fifty=Năm mươi
fill=Lấp đầy
film=Phim ảnh
final=Cuối cùng
find=Tìm thấy
fine=Ổn
finish=Kết thúc
fire=Cháy
first=Đầu tiên
fish=Cá
five=Năm
flat=Bằng phẳng
flight=Chuyến bay
floor=Sàn nhà
flower=Hoa
fly=Bay
follow=Theo dõi
food=Món ăn
foot=Bàn Chân
football=Bóng đá
for=Vì
forget=Quên đi
form=Hình thức
forty=Bốn mươi
four=Bốn
fourteen=Mười bốn
fourth=Thứ tự thứ tư
free=Tự do
friday=Thứ sáu
friend=Bạn bè
friendly=Thân thiện
from=Từ
front=Đằng trước
fruit=Trái cây
full=Đầy
fun=Vui vẻ
funny=Buồn cười
future=Tương lai
game=Trò chơi
garden=Sân vườn
geography=Địa lý
get=Lấy
girl=Con gái
girlfriend=Bạn gái
give=Cho
glass=Thủy tinh
go=Đi
good=Tốt
goodbye=Tạm biệt
grandfather=Ông nội
grandmother=Bà ngoại
grandparent=Ông bà
great=Tuyệt
green=Màu xanh lá
grey=Xám
group=Nhóm
grow=Lớn lên
guess=Đoán
guitar=Đàn ghita
gym=Phòng thể dục
hair=Tóc
half=Một nửa
hand=Tay
happen=Xảy ra
happy=Vui mừng
hard=Cứng, khó
hat=Cái mũ
hate=Ghét bỏ
have=Có
he=Anh ta
head=Cái đầu
health=Sức khỏe
healthy=Khỏe mạnh
hear=Nghe
hello=Xin chào
help=Giúp đỡ
her=Cô ấy,của cô ấy
here=Nơi đây
hey=Này
hi=Chào
high=Cao
him=Anh ta
his=Của anh
history=Lịch sử
hobby=Sở thích
holiday=Ngày lễ
home=Nhà
homework=Bài tập về nhà
hope=Hi vọng
horse=Ngựa
hospital=Bệnh viện
hot=Nóng
hotel=Khách sạn
hour=Giờ
house=Ngôi nhà
how=Thế nào
however=Tuy nhiên
hundred=Trăm
hungry=Đói bụng
husband=Người chồng
I=Tôi
ice=Đá(nước)
idea=Ý tưởng
if=Nếu
imagine=Tưởng tượng
important=Quan trọng
improve=Cải thiện
in=Trong
include=Bao gồm
information=Thông tin
interest=Quan tâm
interested=Quan tâm đến
interesting=Thú vị
internet=Internet
interview=Phỏng vấn
into=Vào trong
introduce=Giới thiệu
island=Đảo
it=Nó
its=Của nó
jacket=Áo khoác
January=Tháng một
jeans=Quần jean
job=Công việc
join=Tham gia
journey=Hành trình
juice=Nước ép
July=Tháng bảy
June=Tháng sáu
just=Chỉ
keep=Giữ 
key=Chìa khóa
kilometre = Kilômét
kind=Tốt bụng
kitchen=Phòng bếp
know=Biết
land=Đất
language=Ngôn ngữ
large=Lớn
last=Cuối cùng
late=Muộn
later=Sau
laugh=Cười
learn=Học
leave=Rời bỏ
left=Bên trái
leg=Chân
lesson=Bài học
let=Để cho
letter=Bức thư
library=Thư viện
lie=Nói dối
life=Đời sống
like=Giống/Thích
light=Ánh sáng/Nhẹ
line=Hàng
lion=Sư tử
list=Danh sách
listen=Nghe
little=Nhỏ bé
live=Sống
local=Địa phương
long=Dài
look=Nhìn
lose=Mất
lot=Rất nhiều
love=Yêu
lunch=Bữa trưa
machine=Cỗ máy
magazine=Tạp chí
main=Chính
make=Làm
man=Đàn ông
many=Nhiều
map=Bản đồ
march=Tháng ba
market=Thị trường, chợ
married=Cưới nhau
match=Cuộc thi đấu
may=Tháng năm
maybe=Có lẽ
me=Tôi
meal=Bữa ăn
mean=Bần tiện, xấu tính
meaning=Ý nghĩa
meat=Thịt
meet=Gặp
meeting=Cuộc gặp gỡ
member=Thành viên
menu=Thực đơn
message=Thông điệp
metre=Mét
midnight=Nửa đêm
mile=Dặm
milk=Sữa
million=Triệu
minute=Phút
miss=Bỏ lỡ
mistake=Sai lầm,điều sai
model=Mẫu, mô hình
modern=Hiện đại
moment=Khoảng khắc
monday=Thứ hai
money=Tiền bạc
month=Tháng
more=Hơn
morning=Buổi sáng
most=Phần lớn
mother=Mẹ
mountain=Núi
mouse=Con chuột
mouth=Miệng
move=Di chuyển
movie=Bộ phim
much=Nhiều
mum=Mẹ
museum=Viện bảo tàng
music=Âm nhạc
must=Phải
modal=Cách thức, phương thức
my=Của tôi
name=Tên
natural=Tự nhiên
near=Ở gần
need=Cần
negative=Phủ định, tiêu cực
neighbour=Hàng xóm
never=Không bao giờ
new=Mới
news=Tin tức
newspaper=Báo chí
next=Tiếp theo
nice=Tốt đẹp
night=Đêm
nine=Chín
nineteen=Mười chín
ninety=Chín mươi
no=Không
nobody=Không có ai
north=Bắc
nose=Mũi
not=Không phải
note=Ghi chú
nothing=Không có gì
november=Tháng mười một
now=Bây giờ
number=Con số
nurse=Y tá
object=Sự vật
october=Tháng Mười
of=Của
off=Tắt
office=Văn phòng
often=Thường
oh=Ồ
OK=Được rồi
old=Cũ
on=Trên
once=Một lần
one=Một
onion=Củ hành
online=Trực tuyến
only=Chỉ có
open=Mở
opinion=Ý kiến
opposite=Đối nghịch
or=Hoặc
orange=Trái cam, màu cam
order=Gọi món
other=Khác
our=Của chúng tôi
out=Ngoài
outside=Ngoài
over=Kết thúc
own=Của riêng
page=Trang
paint=Sơn
painting=Bức tranh
pair=Đôi
paper=Giấy
paragraph=Đoạn văn
parent=Cha mẹ
park=Công viên
part=Phần
partner=Bạn đồng hành
party=Bữa tiệc
passport=Hộ chiếu
past=Vừa qua
prep=Sự chuẩn bị
pay=Trả tiền
pen=Cái bút
pencil=Bút chì
people=Mọi người
pepper=Hạt tiêu
perfect=Hoàn hảo
period=Giai đoạn
person=Người
personal=Riêng tư
phone=Điện thoại
photo=Ảnh
photograph=Ảnh chụp
phrase=Cụm từ
piano=Đàn piano
picture=Hình ảnh
piece=Mảnh
pig=Lợn
pink=Hồng
place=Nơi
plan=Kế hoạch
plane=Máy bay
plant=Thực vật
play=Chơi
player=Người chơi
please=Làm ơn
point=Điểm
police=Cảnh sát
pool=Hồ bơi
poor=Nghèo
popular=Nổi tiếng
positive=Tích cực
possible=Khả thi
post=Bưu kiện
potato=Khoai tây
pound=0.45Kg
practice=Thực tiễn
practise=Tập luyện
prefer=Thích hơn
prepare=Chuẩn bị
present=Hiện tại
pretty=Đẹp
price=Giá bán
probably=Có thể
problem=Vấn đề
product=Sản phẩm
programme=Chương trình
project=Dự án
purple=Màu tím
put=Đặt
quarter=Phần tư
question=Câu hỏi
quick=Nhanh
quickly=Một cách nhanh chóng
quiet=Im lặng
quite=Hoàn toàn
radio=Đài
rain=Cơn mưa
read=Đọc
reader=Người đọc
reading=Đọc hiểu
ready=Sẵn sàng
real=Có thật
really=Thật sự
reason=Lý do
red=Màu đỏ
relax=Thư giãn
remember=Nhớ
repeat=Lặp lại
report=Báo cáo
restaurant=Quán ăn
result=Kết quả
return=Trở về
rice=Cơm
rich=Giàu có
ride=Cưỡi, đạp xe
right=Bên phải
river=Con sông
road=Đường bộ
room=Phòng
routine=Lịch trình
rule=Qui định
run=Chạy
sad=Buồn
salad=Món salad
salt=Muối
same=Tương tự
sandwich=Bánh mì sandwich
saturday=Thứ bảy
say=Nói
school=Trường học
science=Khoa học
scientist=Nhà khoa học
sea=Biển
second=Thứ tự hai/Giây
section=Một phần
see=Thấy
sell=Bán
send=Gửi
sentence=Câu
september=Tháng 9
seven=Bảy
seventeen=Mười bảy
seventy=Bảy mươi
share=Chia sẻ
she=Cô ấy
sheep=Con cừu
shirt=Áo sơ mi
shoe=Giày
shop=Cửa tiệm
shopping=Mua đồ
short=Ngắn
should=Nên
show=Buổi biểu diễn, cho thấy
shower=Tắm vòi hoa sen
sick=Bị ốm
similar=Tương tự
sing=Hát
singer=Ca sĩ
sister=Chị gái/em gái
sit=Ngồi
situation=Tình hình
six=Sáu
sixteen=Mười sáu
sixty=Sáu mươi
skill=Kỹ năng
skirt=Váy
sleep=Ngủ
slow=Chậm
small=Nhỏ bé
snake=Con rắn
snow=Tuyết
so=Vì thế
some=Một số
somebody=Có ai
someone=Người nào đó
something=Thứ gì đó
sometimes=Thỉnh thoảng
son=Con trai
song=Bài hát
soon=Sớm
sorry=Xin lỗi
sound=Âm thanh
soup=Súp
south=Hướng Nam
space=Không gian
speak=Nói
special=Đặc biệt
spell=Đánh vần
spelling=Chính tả
spend=Dùng
sport=Thể thao
spring=Mùa xuân
stand=Đứng
star=Ngôi sao
start=Bắt đầu
statement=Lời tuyên bố
station=Trạm
stay=Ở lại
still=Còn
stop=Dừng lại
story=Câu chuyện
street=Đường phố
strong=Mạnh
student=Sinh viên
study=Nghiên cứu
style=Phong cách
subject=Môn học
success=Thành công
sugar=Đường
summer=Mùa hè
sun=Mặt trời
sunday=Chủ nhật
supermarket=Siêu thị
sure=Chắc chắn rồi
sweater=Áo len
swim=Bơi
swimming=Bơi lội
table=Bàn
take=Cầm lấy
talk=Nói chuyện
tall=Cao
taxi=Xe tắc xi
tea=Trà
teach=Dạy
teacher=Giáo viên
team=Đội
teenager=Thanh thiếu niên
telephone=Điện thoại
television=Tivi
tell=Kể
ten=Mười
tennis=Quần vợt
terrible=Kinh khủng
test=Kiểm tra
text=Chữ
than=Hơn
thanks=Cảm ơn
that=Cái đó
theatre=Rạp hát
their=Của chúng
them=Họ
then=Sau đó
there=Ở đó
they=Họ
thing=Điều
think=Nghĩ
third=Thứ tự ba
thirsty=Khát
thirteen=Mười ba
thirty=Ba mươi
this=Đây
thousand=Nghìn
three=Số ba
through=Xuyên qua
thursday=Thứ năm
ticket=Vé
time=Thời gian
tired=Mệt mỏi
title=Tiêu đề
to=Đến
today=Hôm nay
together=Cùng với nhau
toilet=Phòng vệ sinh
tomato=Cà chua
tomorrow=Ngày mai
tonight=Đêm nay
too=Cũng vậy
tooth=Răng
topic=Chủ đề
tourist=Du khách
town=Thị trấn
traffic=Giao thông
train=Xe lửa
travel=Đi du lịch, đi lại
tree=Cây
trip=Chuyến đi
trousers=Quần dài
true=Thật
try=Thử
tshirt=Áo thun
tuesday=Thứ ba
turn=Xoay
tv=Ti vi
twelve=Mười hai
twenty=Hai mươi
twice=Hai lần
two=Hai
type=Loại hình
umbrella=Ô
uncle=Chú, bác
under=Dưới
understand=Hiểu biết
university=Trường đại học
until=Cho đến khi
up=Lên
upstairs=Tầng trên
us=Chúng ta
use=Sử dụng
useful=Hữu ích
usually=Thường xuyên
vacation=Kì nghỉ
vegetable=Rau quả
very=Rất
video=Video
village=Làng quê
visit=Chuyến thăm
visitor=Khách thăm quan
wait=Chờ đợi
waiter=Phục vụ nam
wake=Thức dậy
walk=Đi bộ
wall=Tường
want=Muốn
warm=Ấm áp
wash=Rửa sạch
watch=Đồng hồ, xem, trông coi
water=Nước
way=Đường, lối đi
we=Chúng tôi
wear=Mặc
weather=Thời tiết
website=Trang mạng
wednesday=Thứ Tư
week=Tuần
weekend=Ngày cuối tuần
welcome=Hoan nghênh, đón chào
well=Tốt
west=Hướng Tây
what=Gì
when=Khi nào
where=Ở đâu
which=Cái mà
white=Trắng
who=Ai
why=Tại sao
wife=Người vợ
will=Sẽ
win=Thắng lợi
window=Cửa sổ
wine=Rượu
winter=Mùa đông
with=Với
without=Không có
woman=Người đàn bà
wonderful=Tuyệt vời
word=Từ
work=Công việc
worker=Người làm việc
world=Thế giới
write=Viết
writer=Nhà văn
wrong=Sai lầm
yeah=Vâng, ừ
year=Năm
yellow=Màu vàng
yesterday=Hôm qua
you=Bạn
young=Trẻ tuổi
yourself=Chính bạn
