absolutely=Chắc chắn rồi
academic=Thuộc về học thuật
access=Truy cập
accommodation=Chỗ ở
account=Tài khoản
achievement=Thành tích
act=Hành động
ad=Quảng cáo
addition=Phép cộng, sự bổ sung
admire=Ngưỡng mộ
admit=Thừa nhận
advanced=Nâng cao
advise=Khuyên nhủ
afford=Có thể, đủ khả năng
age=Tuổi tác
aged=Già đi
agent=Đại lý, điệp viên
agreement=Hiệp định, sự đồng ý
ahead=Phía trước
aim=Mục đích
alarm=Báo thức
album=Album
alcohol=Rượu bia
alcoholic=Kẻ nghiện rượu
alternative=Thay thế
amazed=Kinh ngạc
ambition=Tham vọng
ambitious=Đầy tham vọng
analyse=Phân tích
analysis=Sự Phân tích
announce=Thông báo
announcement=Sự thông báo
annoy=Làm trái ý, gây khó chịu
annoyed=Bực mình
annoying=Phiền phức
apart=Riêng biệt
apologize=Xin lỗi
application=Sự ứng dụng, đơn xin việc
appointment=Cuộc hẹn
appreciate=Đánh giá cao, coi trọng
approximately=Khoảng
arrest=Bắt giữ
arrival=Sự đến
assignment=Sự phân công
assist=Hỗ trợ
atmosphere=Khí quyển
attach=Gắn
attitude=Thái độ
attract=Thu hút
attraction=Sức hút
authority=Thẩm quyền
average=Trung bình
award=Phần thưởng
aware=Nhận thức
backwards=Ngược
bake=Nướng
balance=Thăng bằng
ban=Lệnh cấm
bank=Bờ sông
base=Cơ sở
basic=Cơ bản 
basis=Nền tảng
battery=Pin
battle=Trận đấu
beauty=Sắc đẹp
bee=Con ong
belief=Sự tin tưởng
bell=Chuông
bend=Bẻ cong
benefit=Lợi ích
better=Tốt hơn
bite=Cắn
block=Khối lập phương, chặn
board=Cái bảng
bomb=Bom
border=Biên giới
bother=Làm phiền
branch=Chi nhánh, cành cây
brand=Nhãn hiệu
brave=Dũng cảm
breath=Hơi thở
breathe=Thở
bride=Vị hôn thê
bubble=Bong bóng
bury=Chôn
by=Qua
calm=Trấn tĩnh
campaign=Chiến dịch
campus=Khuôn viên
candidate=Ứng viên
cap=Mũ lưỡi trai
captain=Đội trưởng
careless=Cẩu thả
category=Thể loại
ceiling=Trần nhà
celebration=Lễ kỷ niệm
central=Trung tâm
centre=Trung tâm
ceremony=Lễ
chain=Chuỗi
challenge=Thử thách
champion=Quán quân
channel=Kênh truyền hình
chapter=Chương
charge=Sạc pin
cheap=Rẻ
cheat=Lừa đảo
cheerful=Vui lòng
chemical=Chất Hoá học
chest=Ngực
childhood=Thời thơ ấu
claim=Yêu cầu
clause=Mệnh đề
clear=Xa lạ
click=Nhấp chuột
client=Khách hàng
climb=Trèo
close=Gần
cloth=Vải
clue=Manh mối
coach=Huấn luyện viên
coal=Than đá
coin=Đồng tiền
collection=Thu thập
coloured=Màu sắc rực rỡ
combine=Kết hợp
comment=Bình luận
commercial=Quảng cáo
commit=Phó thác, hứa
communication=Liên lạc
comparison=Sự so sánh
competitor=Đối thủ
competitive=Cạnh tranh
complaint=Lời phàn nàn
complex=Phức tạp
concentrate=Tập trung
conclude=Kết luận
conclusion=Phần kết luận
confident=Tự tin
confirm=Xác nhận
confuse=Nhầm lẫn
confused=Bối rối
connection=Sự liên quan, sự kết nối
consequence=Hậu quả
consist=Bao gồm
consume=Tiêu thụ
consumer=Khách hàng
contact=Tiếp xúc, liên lạc
container=Thùng đựng hàng
content=Nội dung
continuous=Tiếp diễn
contrast=Tương phản
convenient=Tiện lợi
convince=Thuyết phục
cool=Mát mẻ
costume=Trang phục
cottage=Ngôi nhà tranh
cotton=Bông
count=Đếm
countryside=Vùng nông thôn
court=Tòa án
cover=Vỏ bọc, màn che
covered=Đề cập
cream=Kem
criminal=Tội phạm
cruel=Tàn ác
cultural=Thuộc văn hóa
currency=Tiền tệ
current=Hiện hành, hiện tại
currently=Hiện nay
curtain=Tấm màn
custom=Phong tục
cut=Cắt
daily=Hằng ngày
damage=Chấn thương, sự tàn phá
deal=Thỏa thuận
decade=Thập kỷ
decorate=Trang trí
deep=Sâu
define=Định nghĩa
definite=Chắc chắn
definition=Định nghĩa
deliver=Giao
departure=Sự khởi hành
despite=Cho dù
destination=Điểm đến
determine=xác định
determined=Quyết tâm
development=Sự phát triển
diagram=Biểu đồ
diamond=Kim cương
difficulty=Sự khó khăn
direct=Thẳng thắn
directly=Trực tiếp
dirt=Chất bẩn
disadvantage=Bất lợi
disappointed=Thất vọng
disappointing=Đáng thất vọng
discount=Sự giảm giá
dislike=Không thích
divide=Chia
documentary=Phim tài liệu
donate=Quyên tặng
double=Kép
doubt=Nghi ngờ
dressed=Mặc quần áo
drop=Làm rơi
drum=Cái trống
drunk=Say rượu
due=Đến hạn, bởi vì
dust=Bụi
duty=Nghĩa vụ
earthquake=Động đất
eastern=Phương Đông
economic=Thuộc về kinh tế
economy=Nền kinh tế
edge=Bờ rìa
editor=Người biên tập
educate=Giáo dục
educated=Có học thức
educational=Tính giáo dục
effective=Hiệu quả
effectively=Có hiệu quả
effort=Cố gắng
election=Cuộc bầu cử
element=Yếu tố
embarrassed=Thấy xấu hổ
embarrassing=Đáng xấu hổ
emergency=Khẩn cấp
emotion=Cảm xúc
employment=Tình trạng có việc làm
empty=Trống rỗng
encourage=Khuyến khích
enemy=Kẻ thù
engaged=Đính hôn
engineering=Kỹ thuật
entertain=Giải trí
entertainment=Sự giải trí 
entrance=Cổng vào
entry=Lối vào
environmental=Thuộc về môi trường
episode=Tập phim
equal=Bình đẳng
equally=Ngang nhau
escape=Thoát khỏi
essential=Cần thiết
eventually=Sau cùng
examine=Nghiên cứu, phân tích
except=Ngoại trừ
exchange=Trao đổi
excitement=Phấn khích
exhibition=Triển lãm
expand=Mở rộng
expected=Kỳ vọng
expedition=Cuộc thám hiểm
experience=Trải qua
experienced=Có kinh nghiệm
experiment=Cuộc thí nghiệm
explode=Phát nổ
explore=Khám phá
explosion=Vụ nổ
export=Xuất khẩu
extra=Thêm
face=Đối mặt
fairly=Tương đối
familiar=Quen thuộc
fancy=Si mê
far=Xa
fascinating=Lôi cuốn
fashionable=Hợp thời trang
fasten=Đóng lại, thắt dây
favour=Ủng hộ
fear=Nỗi sợ
feature=Tính năng
fence=Rào chắn
fighting=Chiến đấu
file=Tập tin
financial=Tài chính
fire=Lửa
fitness=Sự khỏe khoắn
fixed=Đã sửa, cố định
flag=Lá cờ
flood=Lụt
flour=Bột
flow=Dòng chảy
fold=Gấp
folk=Dân gian
following=Tiếp theo
force=Lực 
forever=Mãi mãi
frame=Khung
freeze=Đóng băng
frequently=Thường xuyên
friendship=Tình bạn
frighten=Dọa sợ
frightened=Sợ sệt
frightening=Khủng khiếp
frozen=Đông cứng
fry=Chiên rán
fuel=Nhiên liệu
function=Hàm số, chức năng
fur=Lông thú
further=Hơn nữa
garage=Ga ra
gather=Tụ họp
generally=Nói chung là
generation=Thế hệ
generous=Rộng lượng
gentle=Dịu dàng
gentleman=Quý ông
ghost=Con ma
giant=Khổng lồ
glad=Vui vẻ
global=Toàn cầu
glove=Găng tay
goods=Các mặt hàng
grade=Lớp
graduate=Tốt nghiệp
grain=Ngũ cốc
grateful=Biết ơn
growth=Sự phát triển
guard=Bảo vệ
guilty=Tội lỗi
hand=Tay
hang=Treo
happiness=Niềm hạnh phúc
hardly=Hầu như không
hate=Ghét bỏ
head=Cái đầu
headline=Tiêu đề
heating=Sưởi
heavily=Nặng nề
helicopter=Trực thăng
highlight=Điểm nổi bật
highly=Được đánh giá cao
hire=Thuê
historic=Mang tính lịch sử
historical=Lịch sử
honest=Thật thà
horrible=Tệ hại
horror=Rùng rợn
host=Chủ nhà
hunt=Săn bắn
hurricane=Bão
hurry=Vội vàng
identity=Danh tính
ignore=Phớt lờ
illegal=Không hợp pháp
imaginary=Tưởng tượng
immediate=Ngay tức khắc
immigrant=Người nhập cư
impact=Va chạm
import=Nhập khẩu
importance=Tầm quan trọng
impression=Ấn tượng
impressive=Đáng ấn tượng
improvement=Sự cải tiến
incredibly=Vô cùng
indeed=Thật
indicate=Biểu thị
indirect=Gián tiếp
indoor=Trong nhà
indoors=Trong nhà
influence=Ảnh hưởng
ingredient=Nguyên liệu
injure=Gây thương tích
injured=Bị thương
innocent=Vô tội
intelligence=Sự thông minh
intend=Có ý định
intention=Chủ đích
invest=Đầu tư
investigate=Điều tra
involved=Có liên quan
iron=Sắt
issue=Vấn đề
it=Nó
journal=Tạp chí
judge=Thẩm phán
keen=Sắc sảo
key=Chìa khóa
keyboard=Bàn phím
kick=Đá
killing=Giết chóc
kind=Tốt bụng
kiss=Hôn
knock=Cú đánh
label=Nhãn mác
laboratory=Phòng thí nghiệm
lack=Thiếu
latest=mới nhất
lay=Đặt nằm
layer=Lớp
lead=Chỉ huy
leaf=Lá cây
leather=Da
legal=Hợp pháp
leisure=Thời gian rảnh rỗi
length=Chiều dài
level=Mức độ
lie=Nói dối
limit=Giới hạn
lip=Môi
liquid=Chất lỏng
literature=Văn chương
live=Trực tiếp
living=Cuộc sống, kế sinh nhai
local=Địa phương
locate=Định vị
located=Xác định vị trí
location=Địa điểm
lonely=Cô đơn
loss=Sự mất mát
luxury=Sang trọng
mad=Điên
magic=Ma thuật
mainly=Chủ yếu
mall=Trung tâm mua sắm
management=Ban quản lý
market=Thị trường
marketing=Tiếp thị
marriage=Hôn nhân
meanwhile=Trong khi đó
measure=Đo lường
medium=Vừa phải
mental=Tâm thần
mention=Đề cập đến
mess=Sự lộn xộn
mild=Nhẹ
mine=Hầm mỏ/Của tôi
mix=Pha trộn
mixture=Hỗn hợp
mood=Tâm trạng
move=Di chuyển
mud=Bùn
murder=Giết người
muscle=Cơ bắp
musical=Âm nhạc
mystery=Bí ẩn
nail=Móng tay
narrative=Chuyện kể
nation=Đất nước 
native=Tự nhiên
naturally=Một cách tự nhiên
necessarily=Nhất thiết
need=Cần
needle=Cây kim
neighbourhood=Khu vực lân cận
neither=Cũng không
net=Mạng lưới
next=Tiếp theo
nor=Cũng không
normal=Thông thường
northern=Phương bắc
note=Ghi chú
now=Bây giờ
nuclear=Nguyên tử
obvious=Rõ ràng
obviously=Rõ ràng
occasion=Dịp
occur=Xảy ra
odd=Số lẻ/Kì lạ
official=Chính thức
once=Một lần
operation=Hoạt động
organized=Được tổ chức
organizer=Người tổ chức
original=Nguyên bản
originally=Ban đầu
ought=Nên 
ours=Của chúng tôi
outdoor=Ngoài trời
outdoors=Ngoài trời
pack=Đóng gói
package=Bưu kiện
painful=Đau đớn
pale=Tái nhợt
pan=Chảo
participate=Tham dự
particularly=Cụ thể
pass=Đi qua
passion=Sự đam mê
path=Đường đi
payment=Thanh toán
peaceful=Bình yên
percentage=Phần trăm 
perfectly=Hoàn hảo
performance=Màn biểu diễn
personally=Theo ý kiến cá nhân
persuade=Theo đuổi
photographer=Nhiếp ảnh gia
photography=Nhiếp ảnh
pin=Ghim
pipe=Đường ống
place=Nơi
planning=Lập kế hoạch
pleasant=Hài lòng
pleasure=Vui lòng
plenty=Nhiều
plot=Kịch bản
plus=Thêm, cộng
poem=Bài thơ
poet=Nhà thơ
poetry=Thơ
point=Điểm
poison=Thuốc độc
poisonous=Độc
policy=Chính sách
political=Chính trị
politician=Chính khách
politics=Chính trị
port=Hải cảng
portrait=Chân dung
possibly=Có khả năng
pot=Nồi
pour=Đổ
poverty=Nghèo nàn
powder=Bột
powerful=Mạnh mẽ
practical=Thực dụng
pray=Cầu nguyện
prayer=Người cầu nguyện
prediction=Sự dự đoán
prepared=Chuẩn bị
presentation=Bài thuyết trình
press=Nhấn
pressure=Sức ép
pretend=Giả vờ
previous=Trước
previously=Trước đây
priest=Thầy tu
primary=Sơ đẳng
prince=Hoàng tử
princess=Công chúa
printing=In ấn
prisoner=Tù nhân
private=Riêng tư
producer=Người sản xuất
production=Sản xuất
profession=Nghề nghiệp
profit=Lợi nhuận
program=Chương trình
promote=Khuyến khích
proper=Thích hợp
properly=Đúng
property=Tài sản
protest=Cuộc biểu tình
proud=Hãnh diện
prove=Chứng tỏ
pull=Sự lôi kéo
punish=Trừng phạt
punishment=Sự trừng phạt
push=Đẩy
qualification=Bằng cấp
qualified=Đạt tiêu chuẩn
qualify=Đủ tiêu chuẩn
queue=Xếp hàng
quit=Từ bỏ
quotation=Sự trích dẫn
quote=Trích dẫn
race=Chủng tộc 
racing=Cuộc đua
range=Phạm vi
rare=Quý hiếm
rarely=Ít khi
reaction=Sự phản ứng
reality=Thực tế
receipt=Biên nhận
recommendation=Sự giới thiệu
reference=Tài liệu tham khảo
reflect=Phản ánh
regularly=Thường xuyên
reject=Từ chối
relate=Kể lại
related=Có quan hệ họ hàng, có liên quan
relation=Quan hệ
relative=Họ hàng
relaxed=Thư thái
relaxing=Thư giãn
release=Phóng thích
reliable=Đáng tin cậy
religion=Tôn giáo
religious=Tôn giáo
remain=Duy trì
remind=Nhắc lại
remote=Xa xôi
rent=Thuê, tiền thuê
repair=Sửa
repeat=Lặp lại
represent=Đại diện cho
request=Lời yêu cầu
require=Yêu cầu
reservation=Dự phòng
resource=Tài nguyên
respect=Kính trọng
responsibility=Trách nhiệm
responsible=Có tinh thần trách nhiệm
result=Kết quả
retire=Về hưu
retired=Nghỉ hưu
revise=Ôn lại
ring=Nhẫn
rise=Nổi lên
risk=Rủi ro
robot=Người máy
roll=Cuộn
romantic=Lãng mạn
rope=Dây
rough=Gồ ghề
row=Hàng ngang
royal=Hoàng Gia
rugby=Bóng bầu dục
rule=Qui định
safety=Sự an toàn
sail=Chèo
sailor=Thủy thủ
sample=Vật mẫu
sand=Cát
scan=Quét
scientific=Thuộc về khoa học
script=Kịch bản
sculpture=Điêu khắc
secondary=Thứ yếu
security=Bảo vệ
seed=Hạt giống
sensible=Hợp lý
separate=Tách rời
seriously=Nghiêm túc
servant=Người hầu
set=Đặt/Bộ
setting=Cài đặt
sex=Tình dục, giới tính
sexual=Mang tính chất tình dục
shake=Rung chuyển
share=Chia sẻ
sharp=Nhọn
shelf=Cái kệ
shell=Vỏ bọc
shift=Sự thay đổi
shine=Chiếu sáng
shiny=Sáng bóng
shoot=Bắn
shy=Nhát
sight=Thị giác, cảnh tượng
signal=Dấu hiệu
silent=Im lặng
silly=Ngốc nghếch
similarity=Sự giống nhau
similarly=Tương tự
simply=Đơn giản
since=Từ
sink=Bồn rửa
slice=Lát cắt
slightly=Khinh bỉ
slow=Chậm
smart=Thông minh
smooth=Trơn tru
software=Phần mềm
soil=Đất
solid=Chất rắn
sort=Loại
southern=Phía Nam
specifically=Đặc biệt
spending=Chi tiêu
spicy=Cay
spirit=Tinh thần
spoken=Đã nói
spot=Điểm
spread=Lan tràn
spring=Mùa xuân
stadium=Sân vận động
staff=Nhân Viên
standard=Tiêu chuẩn
state=Tiểu bang
statistic=Thống kê
statue=Tượng
stick=Dính vào/Cây gậy
still=Còn
store=Cửa hàng
stranger=Người lạ
strength=Sức mạnh
string=Sợi dây
strongly=Mạnh mẽ
studio=Phòng thu
stuff=Đồ đạc
substance=Vật chất
successfully=Thành công
sudden=Đột nhiên
suffer=Đau khổ
suit=Bộ đồ
suitable=Thích hợp
summarize=Tóm tắt
summary=Bản tóm tắt
supply=Cung cấp
supporter=Người ủng hộ
surely=Chắc chắn
surface=Mặt phẳng, bề mặt
survive=Tồn tại, sống sót
swim=Bơi
switch=Thay đổi
symptom=Triệu chứng
tail=Cái đuôi
talent=Tài năng
talented=Có tài
tape=Băng dán
tax=Thuế
technical=Mang tính kĩ thuật
technique=Kĩ thuật
tend=Có khuynh hướng
tent=Cái lều
that=Cái đó
theirs=Của họ
theme=Chủ đề
theory=Học thuyết
therefore=Vì thế
this=Đây
though=Tuy nhiên
throat=Họng
throughout=Khắp
tight=Chặt
till=Cho đến khi
tin=Thiếc
tiny=Nhỏ bé
tip=Tiền boa
toe=Ngón chân
tongue=Lưỡi
total=Toàn bộ
totally=Tổng cộng
touch=Chạm
tour=Chuyến du lịch
trade=Buôn bán
translate=Dịch
translation=Bản dịch
transport=Vận chuyển
treat=Điều trị
treatment=Sự đối đãi
trend=Xu hướng
trick=Bí quyết, Thuật, mẹo
truth=Sự thật
tube=Ống
type=Loại hình
typically=Tiêu biểu
tyre=Lốp xe
ugly=Xấu xí
unable=Không thể
uncomfortable=Khó chịu
underwear=Đồ lót
unemployed=Thất nghiệp
unemployment=Nạn thất nghiệp
unfair=Không công bằng
union=Liên hiệp
unless=Trừ khi
unlike=Không giống
unlikely=Không chắc
unnecessary=Không cần thiết
unpleasant=Khó chịu
update=Cập nhật
upon=Trên
upset=Khó chịu
used=Đã sử dụng
valuable=Quý giá
value=Giá trị
various=Nhiều
version=Phiên bản
victim=Nạn nhân
view=Quan sát
viewer=Người xem
violent=Hung bạo
volunteer=Tình nguyện viên
vote=Bỏ phiếu
warm=Ấm áp
warn=Cảnh báo
warning=Sự cảnh báo
waste=Chất thải
water=Nước
wave=Sóng
weapon=Vũ khí
weigh=Cân
western=Miền Tây
whatever=Sao cũng được
whenever=Bất cứ khi nào
whether=Cho dù
while=Trong khi
whole=Trọn
will=Sẽ
win=Thắng lợi
wing=Cánh
within=Ở trong
wonder=Băn khoăn
wool=Len
worldwide=Trên toàn thế giới
worry=Lo
worse=Tệ hơn
worst=Tồi tệ nhất
worth=Đáng giá
written=Bằng văn bản
wrong=Sai lầm
yard=Sân
young=Trẻ tuổi
youth=Thiếu niên
