ability=Khả năng
able=Có thể
abroad=Nước ngoài
accept=Chấp nhận
accident=Tai nạn
according to=Dựa theo
achieve=Hoàn thành
act=Hành động
active=Tích cực
actually=Thực ra
adult=Người lớn
advantage=Thuận lợi
adventure=Cuộc phiêu lưu
advertise=Quảng cáo
advertisement=Sự quảng cáo
advertising=Quảng cáo
affect=Ảnh hưởng
after=Sau
against=Chống lại
ah=A!, ôi chao
airline=Hãng hàng không
alive=Còn sống
all=Tất cả các
all right=Được rồi
allow=Cho phép
almost=Hầu hết
alone=Một mình
along=Dọc theo
already=Đã sẵn sàng
alternative=Thay thế
although=Mặc dù
among=bị vây quanh bởi
amount=Số lượng
ancient=Cổ đại
ankle=Mắt cá
any=Không tí nào
anybody=Bất kỳ ai
any more=Không nữa
anyway=Dù sao
anywhere=Bất cứ nơi nào
app=Ứng dụng
appear=Hiện ra
appearance=Vẻ bề ngoài
apply=Ứng dụng, tác động
architect=Kiến trúc sư
architecture=Ngành kiến trúc
argue=Tranh cãi
argument=Tranh luận
army=Quân đội
arrange=Sắp xếp
arrangement=Sự sắp xếp
as=Như
asleep=Ngủ
assistant=Trợ lý
athlete=Vận động viên
attack=Tấn công
attend=Tham dự
attention=Chú ý
attractive=Hấp dẫn
audience=Khán giả
author=Tác giả
available=Có sẵn
average=Trung bình
avoid=Tránh xa
award=Phần thưởng
awful=Kinh khủng
back=Mặt sau, lưng
background=Lai lịch, nền, quan cảnh
badly=Tệ
bar=Quán bar
baseball=Bóng chày
based=Dựa trên
basketball=Bóng rổ
bean=Hạt đậu
bear=Con gấu
beat=Đánh đập, đánh bại ai
beef=Thịt bò
before=Trước
behave=Xử sự
behaviour=Hành vi
belong=Thuộc về
belt=Dây nịt, thắt lưng
benefit=Lợi ích
best=Tốt nhất
better=Tốt hơn
between=Giữa
billion=Tỷ
bin=Thùng rác
biology=Sinh học
birth=Sinh con
biscuit=Bánh quy
bit=Chút
blank=Trống
blood=Máu
blow=Thổi
board=Cái bảng
boil=Đun sôi
bone=Xương
book=Sách
borrow=Vay, mượn
boss=Trùm
bottom=Đáy
bowl=Bát
brain=Não
bridge=Cầu
bright=Sáng
brilliant=Rực rỡ
broken=Bị hỏng
brush=Chải
burn=Đốt cháy
businessman=Doanh nhân
button=Cái nút
camp=Trại
camping=Cắm trại
can=lon, hộp, bình
care=Quan tâm
careful=Cẩn thận
carefully=Một cách cẩn thận
carpet=Thảm
cartoon=Hoạt hình
case=Trường hợp
cash=Tiền mặt
castle=Lâu đài
catch=Chụp lấy, bắt
cause=Gây ra
celebrate=Kỉ niệm
celebrity=Người nổi tiếng
certain=Chắc chắn
certainly=Chắc chắn
chance=Cơ hội
character=Tính cách, nhân vật
charity=Từ thiện
chat=Trò chuyện
check=Kiểm tra
chef=Đầu bếp
chemistry=Hoá học
chip= chip điện tử, miếng khoai tây chiên
choice=Sự lựa chọn
church=Nhà thờ
cigarette=Thuốc lá
circle=Vòng tròn
classical=Cổ điển
clear=Rõ ràng
clearly=Một cách rõ ràng
clever=Thông minh
climate=Khí hậu
close=Gần
closed=Đóng cửa
clothing=Quần áo
cloud=Đám mây
coach=Huấn luyện viên
coast=Bờ biển
code=Mã số
colleague=Đồng nghiệp
collect=Sưu tầm
column=Cột
comedy=Hài kịch
comfortable=Thoải mái
comment=Bình luận, nhận xét
communicate=Giao tiếp
community=Cộng đồng
compete=Tranh đua
competition=Cuộc đua, cuộc thi
complain=Than phiền
completely=Hoàn toàn
condition=Tình trạng
conference=Hội nghị
connect=Liên kết
connected=Kết nối
consider=Xem xét
contain=Lưu trữ
context=Ngữ cảnh
continent=Lục địa
continue=Tiếp tục
control=Điều khiển
cook=Đầu bếp
cooker=Nồi cơm điện
copy=Sao chép
corner=Góc
correctly=Một cách chính xác
count=Đếm
couple=Cặp đôi
cover=Che giấu, bao bọc
crazy=Khùng
creative=Sáng tạo
credit=Tín dụng, sự tín nhiệm
crime=Tội ác
criminal=Tội phạm
cross=Đi qua
crowd=Đám đông
crowded=Đông
cry=Khóc
cupboard=Tủ đựng chén
curly=Xoăn
cycle=Đi xe đạp
daily=Hằng ngày
danger=Sự nguy hiểm
dark=Tối
data=Dữ liệu
dead=Chết
deal=Thỏa thuận
dear=Kính thưa
death=Cái chết
decision=Quyết định
deep=Sâu
definitely=Chắc chắn
degree=Bằng cấp
dentist=Bác sĩ nha khoa
department=Phòng ban
depend=Tùy theo
desert=Sa mạc
designer=Nhà thiết kế
destroy=Hủy hoại
detective=Thám tử
develop=Phát triển, xây dựng
device=Thiết bị
diary=Nhật ký
differently=Khác nhau
digital=Kỹ thuật số
direct=Thẳng thắn
direction=Hướng đi
director=Giám đốc
disagree=Không đồng ý
disappear=Biến mất
disaster=Thảm họa
discover=Phát hiện
discovery=Khám phá
discussion=Thảo luận
disease=Bệnh tật
distance=Khoảng cách
divorced=Ly hôn
document=Tài liệu
double=Đôi
download=Tải xuống
downstairs=Tầng dưới
drama=Kịch, sự kiện xúc động
drawing=Đang vẽ
dream=Mơ ước
drive=Lái xe
driving=Điều khiển
drop=Làm rơi
drug=Thuốc, chất gây nghiện
dry=Khô
earn=Kiếm
earth=Trái đất
easily=Một cách dễ dàng
education=Giáo dục
effect=Hiệu ứng
either=Một trong hai
electric=Điện
electrical=Điện
electricity=Điện lực
electronic=Điện tử
employ=Thuê
employee=Nhân viên
employer=Nhà tuyển dụng
empty=Trống rỗng
ending=Kết thúc
energy=Năng lượng
engine=Động cơ
engineer=Kĩ sư
enormous=Lớn lao
enter=Đi vào
environment=Môi trường
equipment=Trang thiết bị
error=Lỗi
especially=Đặc biệt
essay=Bài văn
everyday=Hằng ngày
everywhere=Mọi nơi
evidence=Chứng cớ
exact=Chính xác
exactly=Một cách chính xác
excellent=Xuất sắc
except=Ngoại trừ
exist=Hiện hữu
expect=Chờ đợi
experience=Trải nghiệm, kinh nghiệm
experiment=Cuộc thí nghiệm
expert=Chuyên gia
explanation=Sự giải trình
express=Bày tỏ
expression=Biểu hiện
extreme=Vô cùng
extremely=Vô cùng
factor=Hệ số, yéu tố
factory=Nhà máy
fail=Thất bại
fair=Công bằng
fall=Rơi
fan=Quạt, người hâm mộ
fashion=Thời trang
fear=Nỗi sợ
feature=Tính năng
feed=Cho ăn
female=Giống cái
fiction=Viễn tưởng
field=Đồng ruộng
fight=Đánh nhau
figure=Nhân vật, hình tượng, con số
film=Phim ảnh
final=Cuối cùng
finally=Cuối cùng
finger=Ngón tay
finish=Kết thúc
first=Đầu tiên
firstly=Trước hết
fish=Cá
fishing=Đánh bắt cá
fit=Phù hợp, (cơ thể) khoẻ mạnh
fix=Sửa chữa
flat=Bằng phẳng
flu=Bệnh cúm
fly=Ruồi
flying=Bay
focus=Tập trung
following=Tiếp theo
foreign=Ngoại quốc
forest=Rừng
fork=Cái dĩa
formal=Chính thức, trang trọng
fortunately=Thật may mắn
forward=Ở đằng trước
free=Tự do
fresh=Mới
fridge=Tủ lạnh
frog=Con ếch
fun=Vui vẻ
furniture=Đồ nội thất
further=Hơn nữa
future=Tương lai
gallery=Phòng trưng bày
gap=Khoảng cách
gas=Khí ga
gate=Cổng
general=Chung
gift=Quà tặng
goal=Mục tiêu
god=Chúa Trời
gold=Vàng
golf=Golf
good=Tốt
government=Chính quyền
grass=Cỏ
greet=Chào
ground=Đất
guest=Khách mời
guide=Hướng dẫn
gun=Súng
guy=Chàng
habit=Thói quen
half=Một nửa
hall=Đại sảnh
happily=Hạnh phúc
have=Có
headache=Đau đầu
heart=Trái tim
heat=Nhiệt
heavy=Nặng
height=Chiều cao
helpful=Hữu ích
hero=Anh hùng
hers=Của cô ấy
herself=Chính cô ấy
hide=Ẩn giấu
high=Cao
hill=Đồi núi
himself=Bản thân anh ấy
his=Của anh
hit=Đánh
hockey=Khúc côn cầu
hold=Tổ chức
hole=Hố
home=Trang Chủ
hope=Mong
huge=To lớn
human=Người
hurt=Đau
ideal=Lý tưởng
identify=Nhận định
ill=Ốm
illness=Bệnh
image=Hình ảnh
immediately=Ngay lập tức
impossible=Bất khả thi
included=Bao gồm
including=Bao gồm
increase=Tăng
incredible=Đáng kinh ngạc
independent=Sống độc lập
individual=Riêng biệt, cá nhân
industry=Ngành công nghiệp
informal=Không trang trọng
injury=Vết thương
insect=Côn trùng
inside=Bên trong
instead=Thay vì
instruction=Hướng dẫn
instructor=Người hướng dẫn
instrument=Dụng cụ
intelligent=Thông minh
international=Quốc tế
introduction=Giới thiệu
invent=Phát minh
invention=Sự phát minh
invitation=Lời mời
invite=Mời
involve=Liên quan
item=Món đồ
itself=Chính nó
jam=Mứt
jazz=Nhạc jazz
jewellery=Đồ trang sức
joke=Câu nói đùa
journalist=Nhà báo
jump=Nhảy
kid=Đứa trẻ
kill=Giết chết
king=Nhà vua
knee=Đầu gối
knife=Dao
knock=Cú đánh
knowledge=Hiểu biết
lab=Phòng thí nghiệm
lady=Quý bà
lake=Hồ
lamp=Đèn ngủ
land=Đất
laptop=Máy tính xách tay
last=Cuối cùng
later=Sau
laughter=Tiếng cười
law=Pháp luậ
lawyer=Luật sư
lazy=Lười biếng
lead=Chỉ huy
leader=Lãnh đạo
learning=Học tập 
least=Ít nhất
lecture=Bài giảng
lemon=Chanh
lend=Cho vay
less=Ít hơn
level=Mức độ
lifestyle=Cách sống
lift=Nâng
likely=Rất có thể
link=Liên kết 
listener=Người nghe
little=Nhỏ bé
lock=Khóa
look=Nhìn
lorry=Xe tải
lost=Mất đi
loud=Ồn ào
loudly=Ầm ĩ
lovely=Đáng yêu
low=Thấp
luck=Vận may
lucky=May mắn
mail=Thư
major=Chính
male=Nam giới
manage=Quản lý
manager=Người quản lý
manner=Thái độ
mark=Dấu
marry=Kết hôn
material=Vật chất
mathematics=Toán học
maths=Toán học
matter=Vấn đề, vật chất, quan trọng
may=Có thể
media=Phương tiện truyền thông
medical=Y khoa
medicine=Dược phẩm
memory=Kí ức
mention=Đề cập đến
metal=Kim loại
method=Phương pháp
middle=Ở giữa
might=Có thể
mind=Tâm trí
mine=Của tôi
mirror=Gương
missing=Còn thiếu
mobile=Di động
monkey=Con khỉ
moon=Mặt trăng
mostly=Hầu hết
motorcycle=Xe máy
movement=Sự chuyển động
musical=Âm nhạc
musician=Nhạc sĩ
myself=Riêng tôi
narrow=Chật hẹp
national=Quốc gia
nature=Thiên nhiên
nearly=Gần như
necessary=Cần thiết
neck=Cái cổ
need=Cần
neither=Cũng không
nervous=Bồi hồi, lo lắng
network=Mạng lưới
noise=Tiếng ồn
noisy=Ồn ào
none=Không ai
normal=Thông thường
normally=Thông thường
notice=Để ý
novel=Cuốn tiểu thuyết
nowhere=Hư không
number=Con số
nut=Hạt
ocean=Đại dương
offer=Lời đề nghị
officer=Nhân viên văn phòng
oil=Dầu
onto=Trên
opportunity=Cơ hội
option=Quyền lựa chọn 
ordinary=Bình thường
organization=Cơ quan
organize=Tổ chức
original=Nguyên bản
ourselves=Chính chúng ta
outside=Ngoài
oven=Lò nướng 
own=Riêng
owner=Chủ nhân
pack=Đóng gói
pain=Đau đớn
painter=Họa sĩ
palace=Cung điện
pants=Quần dài
parking=Bãi đậu xe
particular=Cụ thể
pass=Đi qua
passenger=Hành khách
past=Quá khứ
patient=Bệnh nhân
pattern=Họa tiết, hoa văn
pay=Trả tiền
peace=Hòa bình
penny=Đồng xu
per=Mỗi
per cent=Phần trăm
perform=Trình diễn, thực hiện
perhaps=Có lẽ
permission=Sự cho phép
personality=Tính cách
pet=Vật cưng, thú nuôi
petrol=Xăng dầu
photograph=Ảnh chụp
physical=Thuộc về thân thể, Vật lý
physics=Vật lý học
pick=Nhặt
pilot=Phi công
planet=Hành tinh
plant=Thực vật
plastic=Nhựa
plate=Đĩa ăn
platform=Nền tảng
please=Làm ơn
pleased=Vừa lòng
pocket=Túi
polite=Lịch thiệp
pollution=Sự ô nhiễm
pop=Nhạc pop
population=Dân số
position=Chức vụ
possession=Sự sở hữu
possibility=Khả năng
poster=Tấm áp phích 
power=Sức mạnh, năng lượng 
predict=Dự đoán
present=trình chiếu
president=Chủ tịch
prevent=Ngăn ngừa
print=In
printer=Máy in
prison=Tù giam
prize=Phần thưởng
process=Quá trình
produce=Sản xuất
professional=Chuyên nghiệp
professor=Giáo sư
profile=Hồ sơ
program=Chương trình
progress=Tiến triển
promise=Hứa
pronounce=Phát âm
protect=Bảo vệ
provide=Cung cấp
pub=Quán rượu
public=Công cộng
publish=Công bố
pull=Lôi, kéo, giật
purpose=Mục đích
push=Đẩy
quality=Phẩm chất, chất lượng
quantity=Số lượng
queen=Nữ hoàng
question=Câu hỏi
quietly=Lặng lẽ
race=Cuộc đua
railway=Đường sắt
raise=Nuôi, nâng cao lên
rate=Tỷ lệ, tốc độ
rather=Hơn là
reach=Với tới
react=Phản ứng
realize=Nhận ra
receive=Nhận
recent=Gần đây
recently=Gần đây
reception=Sự đón nhận
recipe=Công thức
recognize=Công nhận
recommend=Giới thiệu (khen)
record=Ghi lại
recording=Ghi âm
recycle=Tái chế
reduce=Giảm
refer=Tham khảo
refuse=Từ chối
region=Vùng đất
regular=Thường xuyên
relationship=Mối quan hệ
remove=Gỡ bỏ
repair=Sửa
replace=Thay thế
reply=Đáp lại
report=Báo cáo
reporter=Phóng viên
request=Lời yêu cầu
research=Nghiên cứu
researcher=Nhà nghiên cứu
respond=Phản ứng
response=Sự phản ứng
rest=Nghỉ ngơi/Phần còn lại
review=Kiểm tra lại
ride=Sự đi, cuộc đi
ring=Vòng,nhẫn/Rung chuông
rise=Nổi lên
rock=Đá/Nhạc Rock
role=Vai diễn
roof=Mái nhà
round=Vòng
route=Tuyến đường
rubbish=Rác
rude=Thô lỗ
run=Chạy
runner=Người chạy
running=Đang chạy
sadly=Thật đáng buồn
safe=An toàn
sail=Chèo
sailing=Đi thuyền
salary=Lương
sale=Doanh thu
sauce=Nước sốt
save=Tiết kiệm, cứu
scared=Sợ hãi
scary=Đáng sợ
scene=Cảnh kịch, phim, quang cảnh
schedule=Lịch trình
score=Ghi bàn, điểm số
screen=Màn hình
search=Tìm kiếm
season=Mùa
seat=Ghế
second=Thứ hai
secondly=Thứ hai
secret=Bí mật
secretary=Thư ký
seem=Hình như
sense=Ý nghĩa, giác quan
separate=Tách rời
series=Loạt
serious=Nghiêm túc
serve=Phục vụ
service=Dịch vụ
several=Một số
shake=Rung chuyển
shall=Nên
shape=Hình dạng
sheet=Tờ giấy
ship=Con thuyền
shoulder=Vai
shout=Kêu la
shut=Đóng cửa
side=Cạnh
sign=Dấu hiệu
silver=Màu bạc, kim loại bạc 
simple=Giản dị
since=Từ
singing=Ca hát
single=Độc thân
sir=Quý ngài
site=Địa điểm
size=Kích thước
ski=Trượt tuyết
skiing=Trượt tuyết
skin=Làn da
sky=Bầu trời
sleep=Ngủ
slowly=Chậm rãi
smartphone=Điện thoại thông minh
smell=Đánh hơi, mùi 
smile=Nụ cười
smoke=Khói
smoking=Hút thuốc
soap=Xà bông
soccer=Bóng đá
social=Xã hội
society=Xã hội
sock=Bít tất
soft=Mềm
soldier=Lính
solution=Dung dịch, giải pháp
solve=Giải quyết
somewhere=Một vài nơi
sort=Loại
source=Nguồn
speaker=Loa
specific=Cụ thể
speech=Lời nói
speed=Tốc độ, vận tốc
spider=Con nhện
spoon=Thìa
square=Quảng trường, hình vuông
stage=Sân khấu
stair=Cầu thang
stamp=Con tem
star=Ngôi sao
start=Bắt đầu
state=Tiểu bang
stay=Ở lại
steal=Ăn cắp
step=Bước
stomach=Dạ dày
stone=Sỏi, đá
store=Cửa hàng
storm=Bão táp
straight=Thẳng
strange=Lạ lùng
strategy=Chiến lược
stress=Căng thẳng
structure=Kết cấu
stupid=Ngu
succeed=Thành công
successful=Thành công
such=Như là
suddenly=Đột ngột
suggest=Gợi ý
suggestion=Gợi ý
suit=Bộ đồ
support=Ủng hộ
suppose=Giả sử
sure ad=Chắc chắn ad
surprise=Bất ngờ
surprised=Ngạc nhiên
surprising=Thật ngạc nhiên
survey=Sự khảo sát
sweet=Ngọt
symbol=Biểu tượng
system=Hệ thống
tablet=Máy tính bảng, viên thuốc
talk=Nói chuyện
target=Mục tiêu
task=Nhiệm vụ
taste=Nếm thử, hương vị
teaching=Giảng bài
technology=Công nghệ
teenage=Tuổi teen
temperature=Nhiệt độ
term=Kỳ hạn
text=Chữ
themselves=Chúng tôi
thick=Đặc
thief=Kẻ trộm
thin=Gầy
thinking=Tư duy
third=Thứ ba
thought=Ý nghĩ 
throw=Ném
tidy=Ngăn nắp
tie=Buộc
tip=Tiền boa
tool=Dụng cụ
top=Đứng đầu
touch=Chạm
tour=Chuyến du lịch
tourism=Ngành du lịch 
towards=Đối với
towel=Cái khăn lau
tower=Tòa tháp
toy=Đồ chơi
track=Theo dõi
tradition=Truyền thống
traditional=Cổ truyền
train=Xe lửa
trainer=Huấn luyện viên
training=Tập huấn
transport=Vận chuyển
traveller=Lữ khách
trouble=Rắc rối
truck=Xe tải
twin=Sinh đôi
typical=Đặc trưng
underground=Bí mật
understanding=Sự hiểu biết
unfortunately=Không may
unhappy=Không vui
uniform=Đồng phục
unit=Đơn vị
united=Thống nhất
unusual=Không bình thường
upstairs=Tầng trên
use=Sử dụng
used to=Đã từng
user=Người sử dụng
usual=Bình thường
valley=Thung lũng
van=Xe van
variety=Sự đa dạng
vehicle=Phương tiện giao thông
view=Lượt xem, tầm nhìn
virus=Vi rút
voice=Tiếng nói, giọng nói
wait=Chờ đợi
war=Chiến tranh
wash=Rửa sạch
washing=Rửa
wave=Sóng
weak=Yếu
web=Mạng lưới, mạng nhện
wedding=Lễ cưới
weight=Trọng lượng
welcome=Hoan nghênh
wet=Bị ướt
wheel=Bánh xe
while=Trong khi
whole=Trọn vẹn, tất cả
whose=Của ai
wide=Rộng
wild=Hoang dại
wind=Gió
winner=Người chiến thắng
wish=Điều ước
wood=Gỗ
wooden=Bằng gỗ
working=Đang làm việc
worried=Lo lắng
worry=Lo
worse=Tệ hơn
worst=Tồi tệ nhất
wow=Ồ
yet=Nhưng
yours=Của bạn
zero=Số 0
