abandon=Bỏ rơi
absolute=Tuyệt đối
academic=Thuộc về học thuật
acceptable=Có thể chấp nhận được
accompany=Đồng hành
account=Tài khoản
accurate=Chính xác
accuse=Buộc tội
acknowledge=Thừa nhận
acquire=Có được, thu được
actual=Thật sự
adapt=Thích nghi
additional=Thêm vào
address=Địa chỉ
administration=Sự quản lý
adopt=Nhận nuôi
advance=Tiến bộ, phát triển
affair=Công việc
afterwards=Sau đó
agency=Hãng
agenda=Chương trình nghị sự
aggressive=Hung dữ
aid=Sự giúp đỡ
aircraft=Phi cơ
alarm=Báo thức
alter=Thay đổi
amount=Số lượng
anger=Sự phẫn nộ
angle=Góc
anniversary=Dịp kỉ niệm
annual=Hàng năm
anxious=Lo lắng
apparent=Rõ ràng
apparently=Một cách rõ ràng 
appeal=Sự thu hút, bắt mắt
approach=Cách tiếp cận, tiếp cận
appropriate=Phù hợp
approval=Phê duyệt
approve=Chấp thuận
arise=Nảy sinh
armed=Vũ trang
arms=Cánh tay
artificial=Nhân tạo
artistic=Thuộc về nghệ thuật
ashamed=Hổ thẹn
aspect=Diện mạo
assess=Đánh giá
assessment=Thẩm định, đánh giá
associate=Kết hợp
associated=Có liên quan
association=Sự kết hợp
assume=Giả định
attempt=Nỗ lực
back=Mặt sau
bacteria=Vi khuẩn
bar=Quán bar
barrier=Rào chắn
basically=Về cơ bản
battle=Trận đánh
bear=Chịu (đối phó với)
beat=Đánh đập
beg=Ăn xin
being=Sự tồn tại, sinh vật
bent=Bị bẻ cong 
bet=Cá cược
beyond=Vượt ra ngoài
bill=Hóa đơn
bitter=Vị đắng
blame=Đổ tội
blind=Mù
bond=Liên kết
border=Biên giới
breast=Ngực, vú
brief=Ngắn gọn
broad=Rộng lớn
broadcast=Phát tin
budget=Ngân sách
bullet=Đạn
bunch=Bó lại
burn=Đốt cháy
bush=Bụi rậm
but=Nhưng
cable=Cáp
calculate=Tính toán
cancel=Sự hủy bỏ
cancer=Ung thư
capable=Có khả năng
capacity=Dung tích, giới hạn
capture=Chiếm lấy
cast=Dàn diễn viên
catch=Chụp lấy, bắt giữ
cell=Tế bào
chain=Chuỗi
chair=Cái ghế
chairman=Chủ tịch
challenge=Thách đấu
characteristic=Đặc tính
chart=Đồ thị, biểu đồ
chief=Trưởng nhóm
circumstance=Hoàn cảnh
cite=Trích dẫn
citizen=Người dân
civil=Dân sự
classic=Cổ điển
close=Gần
closely=Chặt chẽ
collapse=Sụp đổ
combination=Sự kết hợp
comfort=An ủi, sự thoải mái 
command=Yêu cầu, ra lệnh 
commission=Uỷ ban
commitment=Lời cam kết
committee=Ủy ban
commonly=Thông thường
complex=Tổ hợp
complicated=Phức tap
component=Thành phần
concentration=Nồng độ
concept=Ý tưởng
concern=Bận tâm
concerned=Lo lắng
conduct=Hạnh kiểm, quản lý
confidence=Lòng tin
conflict=Xung đột
confusing=Gây nhầm lẫn
conscious=Biết rõ
conservative=Bảo thủ
consideration=Sự xem xét
consistent=Thích hợp
constant=Không thay đổi
constantly=Liên tục
construct=Xây dựng
construction=Sự thi công
contemporary=Đương thời
contest=Cuộc thi
contract=Hợp đồng
contribute=Góp phần
contribution=Sự đóng góp
convert=Đổi
convinced=Bị thuyết phục
core=Cốt lõi
corporate=Công ty
council=Hội đồng
county=Quận hạt
courage=Lòng can đảm
crash=Tai nạn, va chạm
creation=Sự tạo thành, tác phẩm 
creature=Sinh vật
credit=Tin, quy công lao cho ai
crew=Phi hành đoàn
crisis=Khủng hoảng
criterion=Tiêu chuẩn
critic=Nhà phê bình
critical=Phê phán, bình phẩm, then chốt
criticism=Sự chỉ trích
criticize=Chỉ trích
crop=Cây trồng, vụ, mùa
crucial=Quan trọng
cry=Khóc
cure=Chữa khỏi
current=Hiện hành
curve=Đường cong
curved=Cong
date=Hẹn hò với ai đó
debate=Tranh luận
debt=Nợ nần
decent=Tử tế
declare=Tuyên bố
decline=Từ chối
decoration=Trang trí
decrease=Giảm bớt
deeply=Sâu sắc
defeat=Đánh bại
defence=Phòng thủ
defend=Phòng vệ
delay=Sự chậm trễ
deliberate=Cố ý, thận trọng, có suy tính 
deliberately=Thong thả
delight=Hân hoan
delivery=Vận chuyển
demand=Yêu cầu
demonstrate=Chứng minh
deny=Phủ nhận
depressed=Suy sụp
depressing=Chán nản
depth=Chiều sâu
desert=Sa mạc
deserve=Xứng đáng
desire=Khao khát
desperate=Tuyệt vọng
detail=Chi tiết
detailed=Chi tiết
detect=Phát hiện
dig=Đào
disc=Đĩa
discipline=Kỷ luật
discount=Miễn giảm
dishonest=Không trung thực
dismiss=Bỏ qua
display=Trưng bày
distribute=Phân phát
distribution=Phân bổ
district=Quận
divide=Chia
division=Phân công
document=Tài liệu
domestic=Nội địa
dominate=Thống trị
downwards=Trở xuống
dozen=Tá (12)
draft=Dự thảo
drag=Lôi kéo
dramatic=Thuộc về kịch, gây ấn tượng
edit=Chỉnh sửa
edition=Phiên bản
efficient=Có hiệu quả
elderly=Người già
elect=Trúng tuyển
elsewhere=Nơi khác
emerge=Hiện ra
emotional=Xúc động
emphasis=Nhấn mạnh
emphasize=Nhấn mạnh
enable=Cho phép
encounter=Bắt gặp
engage=Đính hôn
enhance=Nâng cao
enquiry=Cuộc điều tra
ensure=Chắc chắn
enthusiasm=Hăng hái
enthusiastic=Nhiệt tình
entire=Toàn bộ
entirely=Toàn bộ
equal=Bình đẳng
establish=Thành lập
estate=Tài sản
estimate=Ước tính
ethical=Có đạo đức
evaluate=Đánh giá, định giá 
even=Thậm chí
evil=Độc ác
examination=Kiểm tra
excuse=Thứ lỗi
executive=Chấp hành, quản lý
existence=Sự tồn tại
expectation=Kỳ vọng
expense=Chi phí
exploration=Thăm dò
expose=Phơi ra
extend=Gia hạn
extent=Mức độ
external=Bên ngoài
extraordinary=Đặc biệt
extreme=Vô cùng
facility=Cơ sở
failure=Thất bại
faith=Sự tin tưởng
fault=Lỗi
favour=Ủng hộ
feather=Lông vũ
fee=Phí
feed=Cho ăn
feedback=Phản hồi
feel=Cảm thấy
fellow=Đồng bọn
figure=Suy nghĩ, tính toán
file=Tập tin
finance=Tài chính
finding=Phát hiện
firm=Chắc chắn, cứng rắn
fix=Sửa chữa
flame=Ngọn lửa
flash=Tốc biến
flexible=Linh hoạt
float=Trôi nổi
fold=Nếp gấp
folding=Gấp lại được 
following=Tiếp theo
forgive=Tha lỗi
former=Trước
fortune=Vận may
forward=Ở đằng trước
found=Sáng lập ra
free=Tự do
freedom=Sự tự do
frequency=Tần số
fuel=Nhiên liệu
fully=Đầy đủ
function=Hàm số
fund=Quỹ
fundamental=Cơ bản
funding=Kinh phí
furthermore=Hơn nữa
gain=Lợi
gang=Băng nhóm
generate=Phát ra
genre=Thể loại
govern=Quản lý
grab=Vồ lấy
grade=Lớp
gradually=Dần dần
grand=Lớn
grant=Ban cho
guarantee=Bảo hành
handle=Xử lý
harm=Làm hại
harmful=Có hại
hearing=Thính giác
heaven=Thiên đường
heel=Gót chân
hell=Địa ngục
hesitate=Do dự
high=Cao
hire=Thuê
hold=Tổ chức
hollow=Rỗng
holy=Thánh thiện
honour=Tôn kính
host=Chủ nhà
house=Nhà ở
household=Hộ gia đình
housing=Nhà ở
humorous=Khôi hài
humour=Hài hước
hunt=Săn bắn
hurt=Đau
ideal=Lý tưởng
illustrate=Minh họa
illustration=Hình minh họa
imagination=Trí tưởng tượng
impatient=Nóng nảy, bất bình tĩnh
imply=Bao hàm, ngụ ý
impose=Áp đặt
impress=Gây ấn tượng
impressed=Ấn tượng
inch=2,54 cm
incident=Sự cố
income=Thu nhập = earnings
increasingly=Ngày càng
industrial=Công nghiệp
infection=Sự nhiễm trùng
inform=Báo cáo
initial=Ban đầu
initially=Ban đầu
initiative=Sáng kiến
inner=Bên trong
insight=Cái nhìn thấu suốt
insist=Khăng khăng
inspire=Truyền cảm hứng
install=Tải về
instance=Ví dụ
institute=Học viện
institution=Tổ chức
insurance=Bảo hiểm
intended=Dự định
intense=Mãnh liệt
internal=Nội bộ
interpret=Thông dịch, hiểu
interrupt=Ngắt
investigation=Cuộc điều tra
investment=Sự đầu tư
issue=Vấn đề
joy=Vui sướng
judgement=Sự phán xét
junior=Trẻ em
justice=Sự công bằng
justify=Biện minh
labour=Nhân công
landscape=Phong cảnh
largely=Phần lớn
latest=Muộn nhất
launch=Phóng
leadership=Khả năng lãnh đạo
league=Liên đoàn
lean=Độ nghiêng
leave=Rời bỏ
level=Mức độ
licence=Giấy phép
limited=Giới hạn
line=Hàng
lively=Sống động
load=Trọng tải
loan=Tiền vay
logical=Hợp lý
loose=Lỏng lẻo
lord=Chúa tể
low=Thấp
lower=Thấp hơn
lung=Phổi
maintain=Duy trì
majority=Số đông
make=Làm
map=Bản đồ
mass=Khối lượng
massive=To lớn
master=Bậc thầy
matching=Phù hợp
material=Vật chất
maximum=Tối đa
means=Có nghĩa
measurement=Số liệu đo đạc
medium=Vừa phải
melt=Tan chảy
military=Quân đội
mineral=Khoáng sản
minimum=Tối thiểu
minister=Bộ trưởng, mục sư
minor=Nhỏ hơn, thứ yếu
minority=Thiểu số
mission=Nhiệm vụ
mistake=Sai lầm, điều sai, ngộ nhận
mixed=Trộn
model=Người mẫu, mẫu hình
modify=Biến đổi
monitor=Màn hình
moral=Có đạo đức
motor=Động cơ
mount=Cưỡi, leo trèo lên
multiple=Nhiều
multiply=Nhân
mysterious=Bí ẩn
narrow=Chật hẹp
national=Quốc gia
neat=Gọn gàng
negative=Sự tiêu cực, từ chối, số âm
nerve=Thần kinh
nevertheless=Tuy nhiên
nightmare=Cơn ác mộng
notion=Khái niệm
numerous=Nhiều
obey=Tuân theo
object=Sự vật
objective=Khách quan
obligation=Nghĩa vụ
observation=Quan sát
observe=Quan sát
obtain=Được
occasionally=Thỉnh thoảng
offence=Sự xúc phạm
offend=Xúc phạm
offensive=Phản cảm
official=Chính thức
opening=Khai mạc
operate=Vận hành
opponent=Đối thủ
oppose=Phản đối
opposed=Phản đối
opposition=Phe đối lập
organ=Đàn organ
origin=Nguồn gốc
otherwise=Nếu không thì
outcome=Kết cục
outer=Bên ngoài
outline=Đề cương, dàn ý
overall=Tổng thể
owe=Nợ
pace=Tốc độ
package=Bưu kiện
panel=Bảng điều khiển
parliament=Nghị viện
participant=Người tham gia
partly=Từng phần
passage=Đoạn văn
patient=Bệnh nhân
pension=Lương hưu
permanent=Dài hạn
permit=Cho phép làm gì
perspective=Góc nhìn
phase=Giai đoạn
phenomenon=Hiện tượng
philosophy=Triết học, tư tưởng
pick=Nhặt
picture=Hình ảnh
pile=Đống, chất đống 
pitch=Sân bóng đá
plain=Đơn giản
plot=Kịch bản
plus=Thêm vào, cùng với, cộng
pointed=Nhọn
popularity=Phổ biến
pose=Tư thế
position=Chức vụ, vị trí
positive=Tích cực
possess=Sở hữu
potential=Tiềm năng, tiềm tàng
power=Sức mạnh
praise=Khen
pregnant=Có thai
preparation=Sự chuẩn bị
presence=Sự hiện diện
preserve=Bảo tồn
price=Giá bán
prime=Nguyên tố
principle=Nguyên tắc
print=In
priority=Quyền ưu tiên
privacy=Sự riêng tư
procedure=Thủ tục
process=Quá trình
produce=Sản xuất
professional=Chuyên nghiệp
progress=Tiến triển
project=Dự án
proof=Bằng chứng
proposal=Đề nghị
propose=Cầu hôn
prospect=Tiềm năng
protection=Sự bảo vệ
psychologist=Nhà tâm lý học
psychology=Tâm lý
publication=Sự xuất bản
pupil=Học sinh, đồng tử
purchase=Mua
pure=Thuần khiết
pursue=Theo đuổi
range=Phạm vi
rank=Thứ hạng
rapid=Nhanh
rapidly=Liên tục
rate=Tỷ lệ
raw=Thô
reach=Với tới
realistic=Thực tế
reasonable=Hợp lý
recall=Gợi lại
recover=Hồi phục
reduction=Sự giảm bớt
regard=Về
regional=Khu vực
register=Đăng ký
regret=Hối tiếc
regulation=Quy định
relatively=Tương đối
relevant=Liên quan, thích hợp
relief=Sự cứu tế
rely=Phụ thuộc
remark=Nhận xét
representative=Tiêu biểu
reputation=Danh tiếng
requirement=Yêu cầu
rescue=Giải cứu
reserve=Dự trữ
resident=Cư dân
resist=Kháng cự
resolve=Giải quyết
resort=Nghỉ dưỡng
retain=Giữ lại
reveal=Bộc lộ
revolution=Cuộc cách mạng
reward=Giải thưởng
rhythm=Nhịp
rid=Thoát khỏi
root=Nguồn gốc
round=Vòng
routine=Lịch trình
rub=Chà xát
rubber=Cao su, tẩy
rural=Nông thôn
rush=Cây bấc, (sự) vội vã, xông tới 
sample=Vật mẫu
satellite=Vệ tinh
satisfied=Hài lòng
satisfy=Thỏa mãn
saving=Tiết kiệm
scale=Tỉ lệ, da vảy
schedule=Lịch trình
scheme=Cơ chế
scream=La hét
screen=Màn hình
seat=Ghế
sector=Khu vực
secure=Chắc chắn, an toàn
seek=Tìm kiếm
select=Lựa chọn
selection=Sự lựa chọn
self=Bản thân
senior=Người lớn tuổi
sense=Ý nghĩa, giác quan
sensitive=Nhạy cảm
sentence=Kết án
sequence=Dãy, chuỗi, cảnh phim
session=Phiên, buổi họp
settle=Ổn định
severe=Dữ dội
shade=Bóng râm
shadow=Bóng
shallow=Nông cạn
shame=Xấu hổ
shape=Hình dạng
shelter=Ẩn núp
shift=Sự thay đổi
ship=Vận chuyển
shock=Sốc
shocked=Bị sốc
shooting=Chụp
shot=Phát bắn
significant=Có ý nghĩa
significantly=Đáng kể
silence=Im lặng
silk=Lụa
sincere=Chân thành
slave=Nô lệ
slide=Trượt, ván trượt, mặt nghiêng
slight=Mảnh dẻ, nhẹ nhàng, qua loa
slip=Trượt
slope=Dốc
solar=Liên quan đến mặt trời
somewhat=Phần nào
soul=Linh hồn
specialist=Chuyên gia
species=Loài
speed=Tốc độ, vận tốc
spiritual=Thuộc tâm linh
split=Tách ra
sponsor=Nhà tài trợ
spot=Điểm
spread=Lan tràn
stable=Ổn định
stage=Sân khấu
stand=Đứng
stare=Nhìn chằm chằm
status=Trạng thái
steady=Vững chắc
steel=Thép
steep=Dốc đứng
step=Bước
sticky=Dính
stiff=Cứng
stock=Cổ phần
stream=Dòng
stretch=Căng ra
strict=Nghiêm khắc
strike=Đánh đập, phát đánh
structure=Kết cấu
struggle=Đấu tranh, chật vật 
stuff=Đồ đạc
subject=Môn học
submit=Gửi đi
sum=Tổng
surgery=Phẫu thuật
surround=Vây quanh
surrounding=Bao quanh
survey=Sự khảo sát
suspect=Nghi ngờ
swear=Thề
sweep=Quét
switch=Công tắc, sự thay đổi 
sympathy=Sự đồng cảm
tale=Câu chuyện
tank=Xe tăng
target=Mục tiêu
tear=Nước mắt/vết rách
temporary=Tạm thời
term=Kỳ hạn
therapy=Trị liệu
threat=Mối đe dọa
threaten=Hăm dọa
thus=Do đó
time=Thời gian
title=Tiêu đề
tone=Giọng điệu
tough=Khó, cứng cỏi
track=Theo dõi
transfer=Chuyển khoản
transform=Biến đổi
transition=Chuyển tiếp
trial=Thử nghiệm
trip=Chuyến đi
tropical=Nhiệt đới
trouble=Rắc rối
truly=Thực sự
trust=Lòng tin
try=Thử
tune=Giai điệu
tunnel=Đường hầm
ultimately=Cuối cùng
unconscious=Bất tỉnh
unexpected=Không ngờ tới
unique=Độc nhất
universe=Vũ trụ
unknown=Không xác định
upper=Phía trên
upwards=Trở lên
urban=Đô thị
urge=Thúc giục
value=Giá trị
vary=Thay đổi
vast=Bao la
venue=Địa điểm
very=Rất
via=Thông qua
victory=Chiến thắng
violence=Bạo lực
virtual=Ảo
vision=Tầm nhìn
visual=Trực quan
vital=Thiết yếu
vitamin=Vitamin
volume=Âm lượng, thể tích
wage=Tiền công
way=Đường
weakness=Yếu đuối
wealth=Sự giàu có
wealthy=Giàu có
whereas=Nhưng trái lại
wherever=Bất cứ nơi nào
whisper=Thì thầm
whom=Ai
widely=Rộng rãi
wildlife=Động vật hoang dã
willing=Sẵn lòng
wind=Gió
wire=Dây điện
wise=Khôn ngoan
witness=Nhân chứng
worse=Tệ hơn
worst=Tồi tệ nhất
worth=Đáng giá
wound=Vết thương
wrap=Bọc
wrong=Sai lầm
yet=Đến nay
zone=Vùng
absorb=Hấp thụ
abstract=Trừu tượng 
accent=Giọng nói
accidentally=Tình cờ
accommodate=Cung cấp
accommodation=Chỗ ở
accomplish=Hoàn thành
accountant=Kế toán viên
accuracy=Sự chính xác
accurately=Chính xác
acid=Axit, chua
acre=0.405 hecta
activate=Hoạt động
addiction=Sự nghiện ngập
additionally =Ngoài ra, thêm là
adequate=Đầy đủ
adequately=Một cách đầy đủ
adjust=Điều chỉnh
affordable=Giá cả phải chăng
aged=Già đi, tuổi già
agriculture=Nông nghiệp
alien=Người ngoài hành tinh
alongside=Cùng với, dọc theo
altogether=Hoàn toàn
ambitious=Đầy tham vọng
ambulance=Xe cứu thương
amusing=Vui vẻ, giải trí
analyst=Nhà phân tích
ancestor=Tổ tiên
animation=Hoạt hình
annually=Hàng năm
anticipate=Đoán trước
anxiety=Sự lo ngại
apology=Lời xin lỗi
applicant=Người nộp đơn
appropriately=Thích hợp
arrow=Mũi tên
artwork=Tác phẩm nghệ thuật
asset=Tài sản, của cải
assign=Giao phó
assistance=Sự hỗ trợ
assumption=Giả thiết
assure=Cam đoan
astonishing=Kinh ngạc
athletic=Thuộc về thể thao
attachment=Tập tin đính kèm
audio=Âm thanh
awareness=Nhận thức
awkward=Vụng về
badge=Huy hiệu
balanced=Cân bằng
ballet=Vở ballet
balloon=Bóng bay
barely=Vừa đủ
bargain=Mặc cả
basement=Tầng hầm
basket=Rổ
bat=Con dơi
beneficial=Có lợi
beside=Bên cạnh
besides=Bên cạnh đó
bias=Thiên về cái gì
bid=Đấu thầu, sự trả giá
biological=Sinh học
blanket=Cái chăn
blow=Thổi
bold=In đậm
bombing=Ném bom
boost=Tăng
bound=Ràng buộc
brick=Gạch
briefly=Tóm tắt
broadcaster=Đài truyền hình
broadly=Rộng rãi
buck=Cái xô
bug=Sâu bọ
cabin=Nhà gỗ nhỏ, buồng ngủ
canal=Con kênh
candle=Nến
carbon=Nguyên tố cacbon
castle=Lâu đài
casual=Bình thường
cave=Cái hang
certainty=Sự chắc chắn
certificate=Giấy chứng nhận
challenging=Thách thức
championship=Chức vô địch
charming=Quyến rũ
chase=Săn bắt
cheek=Má
cheer=Nâng cốc, vui lên
chop=Chặt
circuit=Mạch điện
civilization=Nền văn minh
clarify=Làm rõ
classify=Phân loại
cliff=Vách đá
clinic=Phòng khám
clip=Kẹp
coincidence=Sự trùng hợp
collector=Người sưu tầm
colony=Thuộc địa
colorful=Đầy màu sắc
comic=Hài hước
commander=Chỉ huy
comparative=So sánh
completion=Hoàn thành
compose=Soạn, biên soạn
composer=Nhà soạn nhạc
compound=Hợp chất
comprehensive=Toàn diện
comprise=Bao gồm
compulsory=Bắt buộc
concrete=Bê tông
confess=Xưng
confusion=Sự hoang mang
consequently=Hậu quả là
conservation=Sự bảo tồn
considerable=Đáng kể
consistently=Nhất quán
conspiracy=Âm mưu
consult=Tham khảo
consultant=Tư vấn viên
consumption=Sự tiêu thụ
controversial=Gây tranh cãi
convenience=Sự tiện lợi
convention=Quy ước, Hiệp ước
conventional=Theo quy ước
convey=Truyền đạt, dẫn đến
convincing=Thuyết phục
cop=Cảnh sát
cope=Đương đầu
corporation=Tập đoàn
corridor=Hành lang
counter=Phản đối
coverage=Phủ sóng
cowboy=Cao bồi
crack=Nứt, Vết nứt
craft=Thủ công
creativity=Sáng tạo
critically=Nghiêm khắc
cruise=Du thuyền
cue=Gợi ý
curious=Tò mò
curriculum=Chương trình giảng dạy
cute=Dễ thương
dairy=Thuộc về bơ sữa
dare=Dám
darkness=Bóng tối
database=Cơ sở dữ liệu
deadline=Hạn hoàn thành
deadly=Chết người
dealer=Người buôn bán
deck=Boong tàu
defender=Hậu vệ
delete=Xóa bỏ
delighted=Vui mừng
democracy=Nền dân chủ
democratic=Dân chủ
demonstration=Cuộc biểu tình
depart=Khởi hành
dependent=Sự phụ thuộc
deposit=Đặt cọc
depression=Phiền muộn
derive=Lấy được
desperately=Tuyệt vọng
destruction=Sự phá hủy
determination=Sự quyết tâm
devote=Cống hiến
differ=Khác nhau
dime=Đồng xu
disability=Tật, bệnh khiếm khuyết
disabled=Khuyết tật
disagreement=Sự không đống ý
disappoint=Thất vọng
disappointment=Sự thất vọng
discourage=Không khuyến khích
disorder=Rối loạn
distant=Xa xôi
distinct=Riêng biệt
distinguish=Phân biệt
distract=Đánh lạc hướng
disturb=Quấy rầy
dive=Lặn
diverse=Phong phú
diversity=Sự đa dạng
divorce=Ly hôn
dominant=Có ưu thế
donation=Quyên góp
dot=Dấu chấm
dramatically=Đáng kể
drought=Hạn hán
dull=Chán ngắt
dump=Bãi rác
duration=Khoảng thời gian
dynamic=Năng động
eager=Hăng hái
economics=Kinh tế học
economist=Nhà kinh tế học
editorial=Thuộc về biên tập viên
efficiently=Hiệu quả
elbow=Khuỷu tay
electronics=Thiết bị điện tử
elegant=Tao nhã
elementary=Sơ cấp
eliminate=Loại bỏ
embrace=Ôm
emission=Khí thải
emotionally=Tình cảm
empire=Đế chế
enjoyable=Thú vị
entertaining=Giải trí
entrepreneur=Doanh nhân
envelope=Phong bì
equip=Trang bị
equivalent=Tương đương
era=Kỷ nguyên
erupt=Phun trào
essentially=Thiết yếu
ethic=Đạo đức
ethnic=Dân tộc
evaluation=Sự đánh giá
evident=Hiển nhiên
evolution=Sự tiến hóa
evolve=Tiến hóa
exceed=Quá, Hơn
exception=Ngoại lệ
excessive=Quá đáng
exclude=Loại trừ
exotic=Kỳ lạ
expansion=Sự bành trướng
expedition=Cuộc thám hiểm
expertise=Chuyên môn
exploit=Khai thác
exposure=Phơi bày
extension=Sự mở rộng
extensive=Sâu rộng
extensively=Một cách chuyên sâu
extract=Trích xuất
fabric=Vải vóc
fabulous=Tuyệt vời
faculty=Khoa
failed=Thất bại
fake=Giả mạo, Hàng giả
fame=Danh tiếng
fantasy=Tình huống không có thực
fare=Giá vé
firefighter=Lính cứu hỏa
firework=Pháo hoa
firmly=Một cách chắc chắn
flavor=Hương vị
fond=Hạnh phúc
fool=người ngốc nghếch
forbid=Ngăn cấm
forecast=Dự báo
format=Định dạng
formation=Sự hình thành
formerly=Trước kia
fortunate=May mắn
forum=Diễn đàn
fossil=Hóa thạch
foundation=Nền tảng
founder=Người sáng lập
fraction=Phần nhỏ
fragment=Miếng, phần vụn
framework=Khuôn khổ
fraud=Gian lận
freely=Tự do
frequent=Thường xuyên
fulfill=Hoàn thành
fundamentally=Về cơ bản
furious=Giận dữ
gallon=Đơn vị đo âm thanh
gaming=Chơi trò chơi điện tử
gay=Hạnh phúc
gender=Giới tính
gene=Gen
genetic=Di truyền
genius=Thiên tài
genuine=Thành thật
genuinely=Chân thật
gesture=Cử chỉ
globalization=Toàn cầu hóa
globe=Quả địa cầu
golden=Vàng
goodness=Lòng tốt
gorgeous=Rực rỡ
graphic=Thuộc về đồ họa
graphics=Đồ họa
greatly=Rất nhiều
greenhouse=Nhà kính
guideline=Hướng dẫn
habitat=Môi trường sống
harbor=Hải cảng
headquarters=Trụ sở chính
heal=Chữa trị
healthcare=Chăm sóc sức khỏe
helmet=Mũ bảo hiểm
hence=Vì thế
herb=Rau thơm
hidden=Ẩn giấu
hilarious=Vui vẻ
hip=Hông
historian=Nhà sử học
homeless=Vô gia cư
honesty=Trung thực
honey=Mật ong
hook=Cái móc
hopefully=Đầy hy vọng
hunger=Nạn đói
hypothesis=Giả thuyết
icon=Biểu tượng
id=Mã định danh
identical=Giống hệt nhau
illusion=Ảo giác
immigration=Nhập cư
immune=Miễn dịch
implement=Thực hiện
implication=Hàm ý
incentive=Khuyến khích
incorporate=Kết hợp
incorrect=Không đúng
independence=Sự độc lập
index=Mục lục
indication=Sự chỉ dẫn
inevitable=Không thể tránh khỏi
inevitably=Tất yếu
infer=Suy luận
inflation=Lạm phát
info=Thông tin
infrastructure=Cơ sở hạ tầng
inhabitant=Cư dân
inherit=Thừa kế
ink=Mực
innovation=Sự đổi mới
innovative=Đổi mới
input=Đầu vào
insert=Chèn
inspector=Thanh tra
installation=Cài đặt
instant=Lập tức
instantly=Ngay lập tức
integrate=Tích hợp
intellectual=Trí thức
interact=Tương tác
interaction=Sự tương tác
interpretation=Diễn dịch
interval=Khoảng thời gian
invade=Xâm lược
invasion=Cuộc xâm lăng
investor=Chủ đầu tư
isolate=Cô lập
isolated=Bị cô lập
jail=Nhà tù
jet=Máy bay phản lực
joint= Chỗ nối, mối nối
journalism=Nghề báo chí nói chung
jury=Bồi thẩm đoàn
kindergarten=Mẫu giáo
kit=Bộ dụng cụ
ladder=Cái thang
landing=Đổ bộ
lane=Làn đường
lately=Gần đây
legend=Truyền thuyết
lens=Ống kính
lifetime=Cả đời
lighting=Thắp sáng
likewise=Tương tự như vậy
limitation=Sự hạn chế
literally=Theo đúng nghĩa đen
literary=Văn học
litter=Lít
logo=Biểu tượng
lottery=Vé số
loyal=Trung thành
lyric=Lời bài hát
makeup=Trang điểm
manufacture=Chế tạo
manufacturing=Quá trình chế tạo
marathon=Cuộc chạy đua 
margin=Lề
marker=Đánh dấu
martial=Võ thuật
mechanic=Công nhân cơ khí
mechanical=Thuộc về cơ khí
mechanism=Cơ chế
medal=Huy chương
medication=Thuốc
membership=Thành viên
memorable=Đáng nhớ
metaphor=Phép ẩn dụ
miner=Thợ mỏ
miserable=Khổ sở
mode=Cách thức
modest=Khiêm tốn
monster=Quái vật
monthly=Hàng tháng
monument=Đài kỷ niệm
moreover=Hơn thế nữa
mortgage=Thế chấp
mosque=Nhà thờ Hồi giáo
mosquito=Con muỗi
motion=Cử động
motivate=Động viên
motivation=Động lực
moving=Di chuyển
myth=Huyền thoại
naked=Khỏa thân
nasty=Bẩn thỉu
navigation=Dẫn đường
nearby=Gần đây
necessity=Sự cần thiết
negotiate=Thương lượng
negotiation=Cuộc đàm phán
neutral=Trung tính
newly=Mới
nickel=Niken
norm=Định mức
notebook=Sổ tay
novelist=Tiểu thuyết gia
noways=Không đời nào
nursing=Điều dưỡng
nutrition=Dinh dưỡng
obesity=Béo phì
observer=Người quan sát
obstacle=Trở ngại
occupation=Nghề nghiệp
occupy=Chiếm
offender=Người phạm tội
ongoing=Đang diễn ra
openly=Công khai
opera=Một dạng của nhạc kịch
operator=Nhà điều hành
optimistic=Lạc quan
orchestra=Dàn nhạc
organic=Hữu cơ
outfit=Trang phục
output=Đầu ra
outstanding=Vượt trội
overcome=Vượt qua
overnight=Qua đêm
ownership=Quyền sở hữu
oxygen=Ôxy
packet=Gói tin
palm=Lòng bàn tay
panic=Hoảng loạn
pare=Bóc vỏ
parallel=Song song
participation=Sự tham gia
partnership=Quan hệ đối tác
passionate=Say đắm
password=Mật khẩu
patch=Vá
patience=Tính kiên nhẫn
pause=Tạm ngừng
peer=Ngang nhau
penalty=Hình phạt
perceive=Nhận thức
perception=Sự nhận thức
permanently=Vĩnh viễn
pharmacy=Tiệm thuốc
physician=Bác sĩ
pill=Viên thuốc
pity=Thương xót
placement=Vị trí
portion=Phần
potentially=Có tiềm năng
precede=Đứng trước
precious=Quí giá
precise=Tóm lược
precisely=Đúng
predictable=Có thể đoán trước
preference=Sự ưa thích
presidential=Tổng thống
pride=Lòng tự trọng
primarily=Chủ yếu
prior=Trước
probability=Xác suất
probable=Có thể xảy ra
proceed=Tiếp tục
programming=Lập trình
progressive=Cấp tiến
prohibit=Cấm
promising=Hứa hẹn
promotion=Khuyến mãi
prompt=Lời nhắc
proportion=Tỷ lệ
protein=Chất đạm
protester=Người phản đối
psychological=Tâm lý
publicity=Công khai
publishing=Xuất bản
punk=Một thể loại nhạc rock
purely=Hoàn toàn
pursuit=Theo đuổi
puzzle=Câu đố
questionnaire=Bảng câu hỏi
racial=Chủng tộc
racism=Phân biệt chủng tộc
racist=Kẻ phân biệt chủng tộc
radiation=Sự bức xạ
rail=Đường sắt
random=Ngẫu nhiên
rat=Con chuột
rating=Xếp hạng
reasonably=Hợp lý
rebuild=Xây dựng lại
receiver=Người nhận
recession=Suy thoái
reckon=Tính toán
recognition=Sự công nhận
recovery=Sự hồi phục
recruit=Tuyển dụng
referee=Trọng tài
refugee=Người tị nạn
registration=Sự đăng ký
regulate=Điều tiết
reinforce=Củng cố
relieve=Giải tỏa
relieved=An tâm
remarkable=Đáng chú ý
remarkably=Đáng kể
rental=Cho thuê
reporting=Báo cáo
resign=Từ chức
resolution=Nghị quyết
restore=Khôi phục
restrict=Hạn chế
restriction=Sự hạn chế
retail=Bán lẻ
retirement=Sự nghỉ hưu
revenue=Doanh thu
revision=Ôn tập
ridiculous=Lố bịch
risky=Rủi ro
rival=Đối thủ
rob=Cướp
robbery=Vụ cướp
rocket=Tên lửa
romance=Sự lãng mạn
rose=Hoa hồng
roughly=Đại khái
ruin=Sự đổ nát
satisfaction=Sự thỏa mãn
scandal=Vụ bê bối
scare=Dọa
scenario=Kịch bản
scholar=Học giả
scholarship=Học bổng
scratch=Cào
screening=Sàng lọc
seeker=Người tìm kiếm
seminar=Hội thảo
settler=Người định cư
severely=Tàn khốc
sexy=Quyến rũ
shaped=Có hình dạng
shocking=Gây sốc
shore=Bờ biển
shortage=Sự thiếu
sibling=Anh em ruột
sidewalk=Đường đi bộ
signature=Chữ ký
significance=Sự quan trọng
skilled=Có kĩ năng
skull=Đầu lâu
slogan=Phương châm
somehow=Bằng cách nào đó
sometime=Thỉnh thoảng
sophisticated=Tinh vi
spare=Bổ sung
specialize=Chuyên môn hóa
specify=Xác định
spectacular=Hùng vĩ
spectator=Khán giả
speculate=Suy đoán
speculation=Sự suy đoán
spice=Gia vị
spill=Tràn
spite=Cay cú
spoil=Chiều hư
spokesman=Người phát ngôn nam
spokesperson=Người phát ngôn
spokeswoman=Phát ngôn viên nữ
sponsorship=Sự tài trợ
stall=Quầy hàng
stance=Lập trường
starve=Chết đói
steadily=Đều đặn
steam=Hơi nước
stimulate=Kích thích
strengthen=Củng cố
strictly=Nghiêm ngặt
stroke=Cú đánh
stunning=Kinh ngạc
subsequent=Tiếp theo
subsequently=Sau đó
suburb=Ngoại ô
suffering=Đau khổ, chịu đựng
sufficient=Hợp lý
sufficiently=Đủ
super=Siêu
surgeon=Bác sĩ phẫu thuật
survival=Sự sống còn
survivor=Người sống sót
suspend=Đình chỉ
sustainable=Bền vững
swallow=Nuốt
sympathetic=Thông cảm
tackle=Giải quyết
tag=Nhãn
tap=Vỗ nhẹ
technological=Công nghệ
teen=Thiếu niên
temple=Ngôi đền
temporarily=Một cách tạm thời
tendency=Khuynh hướng
tension=Căng thẳng
terminal=Phần cuối
terms=Điều kiện
terribly=Kinh khủng
terrify=Kinh hoàng
territory=Lãnh thổ
terror=Sự kinh hoàng
terrorism=Khủng bố
terrorist=Tên khủng bố
testing=Thử nghiệm
textbook=Sách giáo khoa
theft=Trộm cắp
therapist=Nhà trị liệu
thesis=Luận văn
thorough=Kỹ lưỡng
thoroughly=Triệt để
thumb=Ngón tay cái
timing=Thời gian
tissue=Khăn giấy
tournament=Giải đấu
trace=Dấu vết
trading=Thương mại
tragedy=Bi kịch
tragic=Bi thảm
trait=Đặc điểm
transmit=Chuyển giao
trap=Cạm bẫy
treasure=Châu báu
tribe=Bộ lạc
trigger=Kích hoạt
trillion number=Con số nghìn tỷ
troop=Đoàn quân
tsunami=Sóng thần
ultimate=Tối thượng
unacceptable=Không thể chấp nhận được
uncertainty=Tính không chắc chắn
undergo=Trải qua
undertake=Đảm nhận
unfold=Mở ra
unfortunate=Thật không may
unite=Đoàn kết
unity=Đoàn kết
universal=Phổ cập
urgent=Khẩn cấp
usage=Cách sử dụng
useless=Vô ích
valid=Có giá trị
variation=Biến thể
vertical=Theo chiều dọc
viewpoint=Quan điểm
visa=Hộ chiếu
visible=Có thể nhìn thấy
voluntary=Tình nguyện
voting=Biểu quyết
wander=Đi lang thang
warming=Sự nóng lên
weekly=Hàng tuần
weird=Kỳ dị
welfare=Phúc lợi
wheat=Lúa mì
widespread=Phổ biến rộng rãi
wisdom=Sự khôn ngoan
withdraw=Rút
wolf=Chó sói
workforce=Lực lượng lao động
workplace=Nơi làm việc
workshop=Xưởng
worm=Sâu
wrist=Cổ tay
